./axe/As Meninas - Axé Bahia 2004 - 8 - Tá faltando homem.mp3	axe
./axe/As Meninas - Axé Bahia 2005 - 19 - Com Deus na Frente.mp3	axe
./axe/As Meninas - Largadinho.mp3	axe
./axe/Banda Mel - Bateu Saudade.mp3	axe
./axe/Banda Mel - Prefixo de Verão.mp3	axe
./axe/Banda Mel - Vou Dar a Volta no Mundo.mp3	axe
./axe/Batom Na Cueca - Axé Bahia 2004 - 11 - Arrasta.mp3	axe
./axe/Chiclete com Banana & Ivete Sangalo - Meu bem quero te amar.mp3	axe
./axe/Gera Samba - Cabeçinha.mp3	axe
./axe/Ivente Sangalo - Empurra Empurra.mp3	axe
./axe/Ivete Sangalo & Netinho - Me Abraça.mp3	axe
./axe/Patchanka - Axé Bahia 2004 - 13 - Encarcalo dente.mp3	axe
./axe/Patchanka - Axé Bahia 2004 - 14 - Fruta fresca.mp3	axe
./axe/É o Tchan - 10 Anos ao Vivo (Disc 1) - 10 - Ralando o Tchan.mp3	axe
./axe/É o Tchan - 10 Anos ao Vivo (Disc 1) - 3 - A Tomada.mp3	axe
./axe/É o Tchan - 10 Anos ao Vivo (Disc 1) - 4 - Pega no Bumbum.mp3	axe
./axe/É o Tchan - 10 Anos ao Vivo (Disc 1) - 7 - Tá Com Raiva de Mim & Mão Boba & Festa do Passa Mão.mp3	axe
./axe/É o Tchan - 10 Anos ao Vivo (Disc 2) - 1 - Pega no Ganzá.mp3	axe
./axe/É o Tchan - 10 Anos ao Vivo (Disc 2) - 12 - Simbora, Neném.mp3	axe
./axe/É o Tchan - 10 Anos ao Vivo (Disc 2) - 2 - Dança da Cordinha.mp3	axe
./axe/É o Tchan - 10 Anos ao Vivo (Disc 2) - 7 - É o Tchan & Pau Que Nasce Torto & Melô do Tchan.mp3	axe
./axe/É o Tchan - 10 Anos ao Vivo (Disc 2) - 8 - Se Bulindo & Saravá.mp3	axe
./axe/É o Tchan - Ligado em 220v - 12 - Madeira.mp3	axe
./axe/É o Tchan - Ligado em 220v - 13 - Trombone.mp3	axe
./axe/É o Tchan - Ligado em 220v - 4 - Parece um Furacão (Rebola).mp3	axe
./axe/É o Tchan - Ligado em 220v - 5 - Alabumbunê.mp3	axe
./axe/É o Tchan - Ligado em 220v - 8 - Baixo Desafinado.mp3	axe
./axe/É o Tchan - Na Boca da Garrafa.mp3	axe
./axe/É o Tchan - Na Selva - 14 - Papo Quente.mp3	axe
./axe/É o Tchan - Na Selva - 15 - Tchan é Bala.mp3	axe
./axe/É o Tchan - Na Selva - 4 - FlinstChans.mp3	axe
./axe/É o Tchan - Na Selva - 9 - Jeitinho Manhoso.mp3	axe
./axe/É o Tchan - Onda Onda.mp3	axe
./axe/É o Tchan - Pega No Bumbum.mp3	axe
./axe/É o Tchan - Talquinho.mp3	axe
./axe/É o Tchan - É o Tchan No Havaí - 12 - Chamadinha.mp3	axe
./axe/É o Tchan - É o Tchan No Havaí - 14 - Teca terereca.mp3	axe
./axe/É o Tchan - É o Tchan No Havaí - 15 - Cipo empenado.mp3	axe
./axe/É o Tchan - É o Tchan No Havaí - 4 - Tasta chinelo.mp3	axe
./axe/É o Tchan - É o Tchan No Havaí - 9 - Twist.mp3	axe
./bachata/Domenic Marte - Ven tu.mp3	bachata
./bachata/Elvis Diaz - Borracho.mp3	bachata
./bachata/Extreme - Shala.mp3	bachata
./bachata/Huellas Del Tiempo - Realidad.mp3	bachata
./bachata/Joe Veras - Coje Cuadre.mp3	bachata
./bachata/Joe Veras - Desde Que Me Dejaste.mp3	bachata
./bachata/Joe Veras - Dime Corazon.mp3	bachata
./bachata/Joe Veras - Fallaste.mp3	bachata
./bachata/Joe Veras - Por Tus Celos.mp3	bachata
./bachata/Joe Veras - Por tu Amor.mp3	bachata
./bachata/Joe Veras - Se Te Nota.mp3	bachata
./bachata/José Manuel - Se te nota.mp3	bachata
./bachata/Juan Manuel - Tu Eres Ajena.mp3	bachata
./bachata/Luis Miguel del Amargue - Amor de Locos - 2 - Amor De Locos.mp3	bachata
./bachata/Luis Miguel del Amargue - Amor de Locos - 6 - Sin Miedo A Nada.mp3	bachata
./bachata/Luis Miguel del Amargue - Bachatas Nuevas.mp3	bachata
./bachata/Luis Miguel del Amargue - Hoy la vi Pasar.mp3	bachata
./bachata/Luis Miguel del Amargue - Quiero amanacer contigo.mp3	bachata
./bachata/Monchy & Alexandra - Confesiones - 1 - Te Quiero Igual Que Ayer.mp3	bachata
./bachata/Monchy & Alexandra - Confesiones - 10 - Aqui Estare.mp3	bachata
./bachata/Monchy & Alexandra - Confesiones - 12 - El Soñador.mp3	bachata
./bachata/Monchy & Alexandra - Confesiones - 5 - Ven, Dime Como Hago.mp3	bachata
./bachata/Monchy & Alexandra - Confesiones - 6 - Polo Oquesto.mp3	bachata
./bachata/Monchy & Alexandra - Confesiones - 7 - Cuando No Se Puede Olvidar.mp3	bachata
./bachata/Monchy & Alexandra - Confesiones - 8 - Te Amaria.mp3	bachata
./bachata/Monchy & Alexandra - Confesiones - 9 - El Precio De Tu Engaño.mp3	bachata
./bachata/Monchy & Alexandra - Hasta el Fin - 1 - Perdidos.mp3	bachata
./bachata/Monchy & Alexandra - Hasta el Fin - 3 - Hasta el Fin.mp3	bachata
./bachata/Monchy & Alexandra - Hasta el Fin - 5 - No te prometo.mp3	bachata
./bachata/Monchy & Alexandra - Hasta el Fin - 8 - Fantasias.mp3	bachata
./bachata/Monchy & Alexandra - Hoja En Blanco - 1 - Hoja en Blanco.mp3	bachata
./bachata/Monchy & Alexandra - Hoja En Blanco - 3 - En el Muelle de San Blas.mp3	bachata
./bachata/Monchy & Alexandra - Hoja En Blanco - 7 - No Puedo Vivir Asi.mp3	bachata
./bachata/Monchy & Alexandra - Llorando Pena.mp3	bachata
./bachata/Monchy & Alexandra - No Soy Culpable.mp3	bachata
./bachata/Monchy & Alexandra - No me pidas.mp3	bachata
./bachata/Monchy & Alexandra - Quiero saber de ti.mp3	bachata
./bachata/Monchy & Alexandra - Recuerdo Tus Ojos.mp3	bachata
./bachata/Nueva Era - Amor Eterno.mp3	bachata
./bachata/Zacararias Ferreira - Puro Sentimiento.mp3	bachata
./bolero/Aida Cuevas - Boleros Voz Y Sentimiento - CD 02 - 5 - Vanidad.mp3	bolero
./bolero/Alejandro Sanz - Corazón partio.mp3	bolero
./bolero/America - Boleros Voz Y Sentimiento - CD 01 - 6 - Sabra Dios.mp3	bolero
./bolero/Anna Belen & Antonio Banderas - Boleros Latinos II - 8 - No sé por que té quiero.mp3	bolero
./bolero/Charlie Zaa - Boleros Latinos I - 12 - Niegalo todo.mp3	bolero
./bolero/Chico Buarque - Mulheres De Atenas.mp3	bolero
./bolero/Dany Brillant - Boleros Latinos I - 6 - Pourtant.mp3	bolero
./bolero/Djavan - Se.mp3	bolero
./bolero/Ellis Regina - Dois Pra La, Dois Pra Ca.mp3	bolero
./bolero/Emílio Santiago - Dilema.mp3	bolero
./bolero/Emílio Santiago - Emílio Santiago.mp3	bolero
./bolero/Gal Costa & Tom Jobin - Tema de Amor de Gabriela.mp3	bolero
./bolero/Gal Costa - Dom de iludir.mp3	bolero
./bolero/Gal Costa - Meu bem, meu mau.mp3	bolero
./bolero/Gal Costa - Você me dá sorte.mp3	bolero
./bolero/Gilberto Gil -  - Estrela.mp3	bolero
./bolero/Javier Solís - Boleros Voz Y Sentimiento - CD 02 - 12 - Tres Palabras.mp3	bolero
./bolero/Joanna - Tu me acostumbraste.mp3	bolero
./bolero/Leo Marini - Fichas Negras.mp3	bolero
./bolero/Leo Marini - Hotel de Verano.mp3	bolero
./bolero/Linda Ronstadt - Boleros Latinos I - 10 - Perfídia.mp3	bolero
./bolero/Los Tres Ases - Venganza.mp3	bolero
./bolero/Luis Miguel - Boleros Latinos I - 15 - La barca.mp3	bolero
./bolero/Luis Miguel - Boleros Latinos II - 18 - El reloj.mp3	bolero
./bolero/Luis Miguel - Boleros Latinos II - 5 - Sabor a mi.mp3	bolero
./bolero/Luis Miguel - Contigo en la distancia.mp3	bolero
./bolero/Luis Miguel - La mentira.mp3	bolero
./bolero/Luis Miguel - Mexico En La Piel - 3 - Echame A Mi La Culpa.mp3	bolero
./bolero/Luis Miguel - Mexico En La Piel - 8 - Motivos.mp3	bolero
./bolero/Luis Miguel - Mis Boleros Favoritos - 11 - Encadenados.mp3	bolero
./bolero/Luis Miguel - Mis Boleros Favoritos - 2 - La Barca.mp3	bolero
./bolero/Luis Miguel - Mis Boleros Favoritos - 7 - Solamente Una Vez.mp3	bolero
./bolero/Magneto - Boleros Voz Y Sentimiento - CD 02 - 3 - Quien Sera.mp3	bolero
./bolero/Marc Anthony - Boleros Latinos III - 10 - Vieja mesa.mp3	bolero
./bolero/Marc Anthony - Otra Nota - 5 - Make It You.mp3	bolero
./bolero/Reginaldo Rossi - Mon Amour.mp3	bolero
./bolero/Sasha - Boleros Voz Y Sentimiento - CD 01 - 4 - Sorpresa.mp3	bolero
./bolero/Tatiana - Boleros Voz Y Sentimiento - CD 02 - 8 - Obsesión.mp3	bolero
./bolero/Tânia Alves - Quero amanhecer amando.mp3	bolero
./bolero/Victor Victor & La Vellonera - Boleros Latinos III - 8 - La peste.mp3	bolero
./forro/Alceu Valença & Elba Ramalho & Geraldo Azevedo & Zé Ramalho - Coracao Bobo (Ao Vivo).mp3	forro
./forro/Aviões do Forró - Chama a patricinha pra dançar.mp3	forro
./forro/Aviões do Forró - Eu Boto ou Não Boto.mp3	forro
./forro/Bicho De Pé - Nosso Xote.mp3	forro
./forro/EstakaZero - Deixa doido eu.mp3	forro
./forro/EstakaZero - Você Se Foi.mp3	forro
./forro/Estakazero - Mandacaru.mp3	forro
./forro/Estakazero - Vem Viver.mp3	forro
./forro/Falamansa - Deixa Entrar - 10 - Asas.mp3	forro
./forro/Falamansa - Deixa Entrar - 13 - Minha Gata.mp3	forro
./forro/Falamansa - Deixa Entrar - 5 - Confidência.mp3	forro
./forro/Falamansa - Deixa Entrar - 6 - Forró de Tóquio.mp3	forro
./forro/Falamansa - Deixa Entrar - 8 - Avisa.mp3	forro
./forro/Falamansa - Um Dia Perfeito - 1 - Um Dia Perfeito.mp3	forro
./forro/Falamansa - Um Dia Perfeito - 12 - Roendo Unha.mp3	forro
./forro/Falamansa - Um Dia Perfeito - 14 - A Despedida.mp3	forro
./forro/Falamansa - Um Dia Perfeito - 3 - Tempo De Paz.mp3	forro
./forro/Falamansa - Um Dia Perfeito - 6 - Gotas De Amor.mp3	forro
./forro/Falamansa - Um Dia Perfeito - 8 - Onde Esta Voce.mp3	forro
./forro/Falamansa - Xote Universitário.mp3	forro
./forro/Gilberto Gil - São João Ao Vivo - Cajuína  Refazenda.mp3	forro
./forro/Gilberto Gil - São João Ao Vivo - Esperando na Janela.mp3	forro
./forro/Gilberto Gil - São João Ao Vivo - Eu Só Quero um Xodó.mp3	forro
./forro/Gilberto Gil - São João Ao Vivo - Olha pro Céu.mp3	forro
./forro/Gilberto Gil - São João Ao Vivo - Toda Menina Baiana.mp3	forro
./forro/Gilberto Gil - São João Ao Vivo - Óia Eu Aqui de Novo.mp3	forro
./forro/Nó de Forró - Brisa.mp3	forro
./forro/Nó de Forró - Cebola Cortada.mp3	forro
./forro/Nó de Forró - Me leva.mp3	forro
./forro/Nó de Forró - Não é milagre.mp3	forro
./forro/Nó de Forró - Olhando a Lua.mp3	forro
./forro/Nó de Forró - Zabumba.mp3	forro
./forro/Nó de Forró - À Toa.mp3	forro
./forro/Trio Chama Chuva - Forró de Itaúnas - 2 - Samarina.mp3	forro
./forro/Trio Chama Chuva - Forró de Itaúnas - 5 - Forró de Itaúnas.mp3	forro
./forro/Trio Forrozão - Trio Forrozão - 1 - Forró da Musa.mp3	forro
./forro/Trio Forrozão - Trio Forrozão - 10 - Amei À Toa.mp3	forro
./forro/Trio Forrozão - Trio Forrozão - 14 - Casa da Saudade.mp3	forro
./forro/Trio Forrozão - Trio Forrozão - 3 - Os Homi da Paraíba.mp3	forro
./forro/Trio Virgulino & Dominguinhos - A sorte é cega.mp3	forro
./gaucha/Alma Serrana - Alma Serrana - Ao vivo - 10 - Amargurado.mp3	gaucha
./gaucha/Chiquito & Bordoneio - Cada Vez Melhor - 12 - Essa Moda Vai Pegá.mp3	gaucha
./gaucha/Chiquito & Bordoneio - Cada Vez Melhor - 5 - Na Paz do Campo.mp3	gaucha
./gaucha/Chiquito & Bordoneio - Cada Vez Melhor - 6 - Mais Que a Minha Vida.mp3	gaucha
./gaucha/Chiquito & Grupo Bordoneio - Só Vanerão - Volume 4 - 4 - Vanerão do Pião.mp3	gaucha
./gaucha/Eco do Minuano & Bonitinho - Bem Gaúcho - 1 - Gaúcho Apaixonado.mp3	gaucha
./gaucha/Eco do Minuano & Bonitinho - Bem Gaúcho - 10 - Bella.mp3	gaucha
./gaucha/Eco do Minuano & Bonitinho - Bem Gaúcho - 11 - As Cordeonas do Rio Grande.mp3	gaucha
./gaucha/Eco do Minuano & Bonitinho - Bem Gaúcho - 4 - Perdão.mp3	gaucha
./gaucha/Eco do Minuano & Bonitinho - Bem Gaúcho - 7 - Correntina Linda.mp3	gaucha
./gaucha/Garotos de Ouro - Dose Dupla - 1 - Morenaca.mp3	gaucha
./gaucha/Garotos de Ouro - Dose Dupla - 12 - Barraca  arcada.mp3	gaucha
./gaucha/Garotos de Ouro - Dose Dupla - 20 - Assanhado.mp3	gaucha
./gaucha/Gonzaga dos Reis - Os Melhores Xotes Gaúchos Vol. 1 - 7 - Fim de Baile.mp3	gaucha
./gaucha/Grupo Estampa - Chão Batido - 10 - Meu Ranchito.mp3	gaucha
./gaucha/Grupo Manotaço - Chão Batido - 11 - Bem à Moda Antiga.mp3	gaucha
./gaucha/Grupo Manotaço - Só Vanerão - Volume 4 - 6 - Até Posso Casar.mp3	gaucha
./gaucha/Grupo Minuano - Músicas da Nossa Terra ZH - 11 - Bebum.mp3	gaucha
./gaucha/Grupo Rodeio - Carreteadas - 3 - Saudade Carga Pesada.mp3	gaucha
./gaucha/Grupo Rodeio - Carreteadas - 7 - Cavalgadas do Rio Grande.mp3	gaucha
./gaucha/Grupo Rodeio - Carreteadas - 9 - Tropeiro.mp3	gaucha
./gaucha/Grupo Rodeio - Festchê 1 - 6 - Gritos de liberdade.mp3	gaucha
./gaucha/Grupo Trumã - Os Melhores Xotes Gaúchos Vol. 1 - 3 - Buenas Amigo.mp3	gaucha
./gaucha/Grupo candeeiro - Canto E Encanto Nativo - Vol 3 - 2 - lamento de um velho pescador.mp3	gaucha
./gaucha/Iedo silva - Canto E Encanto Nativo - Vol 3 - 14 - xote laranjeira.mp3	gaucha
./gaucha/Luis Carlos Pereira - Baile de Fronteira - 10 - Alvorada Serrana.mp3	gaucha
./gaucha/Luiz Cardoso & Aurélio Leal - Os Melhores Xotes Gaúchos Vol. 1 - 11 - Xote Laranjeira.mp3	gaucha
./gaucha/Marinês Siqueira & Grupo Missões - Só Vanerão - Volume 4 - 7 - Chapa de Fogão.mp3	gaucha
./gaucha/Os Nativos - Músicas da Nossa Terra ZH - 3 - A primeira vez.mp3	gaucha
./gaucha/Os Nativos - Santo Chão - 2 - Castelhana.mp3	gaucha
./gaucha/Os Serranos - 25 Anos de Música para o Brasil - 12 - Canção ao Mundo Novo.mp3	gaucha
./gaucha/Os Serranos - 25 Anos de Música para o Brasil - 7 - Veterano.mp3	gaucha
./gaucha/Os Veteranos - Show de Xote e Vaneirão - 8 - Cavaleiro.mp3	gaucha
./gaucha/Paulo Costa - Milongas Gaúchas V2 - 7 - Milonga de Capataz.mp3	gaucha
./gaucha/Paulo Siqueira - Milongas Gaúchas V2 - 6 - Velho Chapéu.mp3	gaucha
./gaucha/Tchê Barbaridade - 10 Anos Mais Fandangueiro - 13 - Yo te quiero tanto.mp3	gaucha
./gaucha/Tchê Barbaridade - 20 Grandes Sucessos - 14 - Uma Negrinha Me Esperando.mp3	gaucha
./gaucha/Tchê Barbaridade - 20 Grandes Sucessos - 19 - Apaixonao.mp3	gaucha
./gaucha/Tchê Barbaridade - 20 Grandes Sucessos - 21 - Vanerão do Adeus.mp3	gaucha
./gaucha/Tchê Barbaridade - 20 Grandes Sucessos - 9 - Ao Som de Um Gaitaço.mp3	gaucha
./merengue/Alberto Flash - El pecaito.mp3	merengue
./merengue/Arnaldo - Merengue Mania 2003 - CD3 - 5 - Yo La Quiero.mp3	merengue
./merengue/Brassa Ardiente - Merengue Mania 2003 - CD4 - 5 - Triste Corazón.mp3	merengue
./merengue/Deskkontrolados - Merengue Mania 2003 - CD4 - 14 - Que Quieres De Mi.mp3	merengue
./merengue/El Combo Dominicano - Los 100 Mayores Exitos De La Musica Salsa CD1 - 21 - Se me murio el canario.mp3	merengue
./merengue/El Costo De La Vida - El Niagara En Bicicleta.mp3	merengue
./merengue/El Jeffrey - Palabritas.mp3	merengue
./merengue/El Jeffrey - Pobre diablo.mp3	merengue
./merengue/Evils Crespo & Grupo Mania - Merengue Mania 2003 - CD4 - 9 - Ojitos Bellos.mp3	merengue
./merengue/Extra Banda - Merengue Mania 2003 - CD2 - 17 - Feo Pa´La Foto.mp3	merengue
./merengue/Grupo 747 - Merengue Mania 2003 - CD3 - 6 - No Se Olvida.mp3	merengue
./merengue/Grupo Mania - La Hora De La Verdad - 11 - Tamtindo Seco.mp3	merengue
./merengue/Grupo Mania - Sacala a bailar.mp3	merengue
./merengue/Homeboys - Merengue Mania 2003 - CD1 - 15 - Arrancame.mp3	merengue
./merengue/Jose Juan - Merengue Mania 2003 - CD3 - 8 - Un Mal Necesario.mp3	merengue
./merengue/Jossie Esteban - El Tigueron.mp3	merengue
./merengue/Jossie Esteban - Merengue Mania 2003 - CD1 - 18 - De Fin De Semana.mp3	merengue
./merengue/Julian - La Cavana.mp3	merengue
./merengue/La Banda Flakka - Merengue Mania 2003 - CD2 - 14 - Te Olvidaste de Mi.mp3	merengue
./merengue/La Fuerza - Merengue Mania 2003 - CD4 - 6 - Loco Enamorado.mp3	merengue
./merengue/La Linea - Merengue Mania 2003 - CD1 - 13 - Si me Dejas No Vale.mp3	merengue
./merengue/La Magia - Merengue Mania 2003 - CD3 - 16 - El Vegetariano.mp3	merengue
./merengue/La Nueva Patrulla 15 - Merengue Mania 2003 - CD4 - 7 - El Amolao.mp3	merengue
./merengue/Los Sabrosos del Merengue - Los 100 Mayoreas Exitos De La Salsa CD3 - 13 - Sabrosa que está.mp3	merengue
./merengue/Los Toros Band - No pude quitarte las espinas.mp3	merengue
./merengue/Los Toros Band - Te Quiero.mp3	merengue
./merengue/Manikkomio - Merengue Mania 2003 - CD2 - 7 - La Rubia Candela.mp3	merengue
./merengue/Manny Valenz - Merengue Mania 2003 - CD3 - 17 - El Vecino.mp3	merengue
./merengue/Manole Manole - Merengue Mania 2003 - CD3 - 18 - Yo Me Enamore.mp3	merengue
./merengue/Maremoto - Merengue Mania 2003 - CD2 - 20 - El Toro.mp3	merengue
./merengue/Nelson De La Olla - La Cebolla.mp3	merengue
./merengue/Olga Tañon - Muchacho Malo.mp3	merengue
./merengue/Orquestra Caracas - Nada Cambiará Mi Amor Por Tí.mp3	merengue
./merengue/Papucho Y Su Grupo Wao - Merengue Mania 2003 - CD1 - 12 - Me Has Echado Al Olvido.mp3	merengue
./merengue/Raulin Rodriguez - Los Resbalones.mp3	merengue
./merengue/Ray Lopez - Merengue Mania 2003 - CD3 - 7 - Como Lo Hice Yo.mp3	merengue
./merengue/Ricky Castro Y Su Banda Soberbia - Merengue Mania 2003 - CD2 - 19 - El Elano.mp3	merengue
./merengue/Sandy & Papo - La Fiesta.mp3	merengue
./merengue/Swing Divino - Merengue Mania 2003 - CD3 - 4 - Si Me Ves Llorar Por Ti.mp3	merengue
./merengue/Tony Rivas - Merengue Mania 2003 - CD2 - 13 - Enemiga De Este Amor.mp3	merengue
./pagode/Dudu Nobre - Ao Vivo - 1 - Água Da Minha Sede.mp3	pagode
./pagode/Dudu Nobre - Ao Vivo - 10 - Singelo Menestrel.mp3	pagode
./pagode/Dudu Nobre - Ao Vivo - 12 - Estava Perdido Num Mar.mp3	pagode
./pagode/Dudu Nobre - Ao Vivo - 13 - Favo de Mel.mp3	pagode
./pagode/Dudu Nobre - Ao Vivo - 14 - Nossa Oração.mp3	pagode
./pagode/Dudu Nobre - Ao Vivo - 15 - Quebro, Não Envergo.mp3	pagode
./pagode/Dudu Nobre - Ao Vivo - 16 - Louco Pra Te Dar Um Beijo.mp3	pagode
./pagode/Dudu Nobre - Ao Vivo - 20 - Goiabada Cascão.mp3	pagode
./pagode/Dudu Nobre - Ao Vivo - 3 - A Família Aumentou.mp3	pagode
./pagode/Dudu Nobre - Ao Vivo - 4 - Tempo De Don Don.mp3	pagode
./pagode/Dudu Nobre - Ao Vivo - 5 - A Grande Família.mp3	pagode
./pagode/Dudu Nobre - Ao Vivo - 6 - Vou Botar Teu Nome Na Macumba.mp3	pagode
./pagode/Dudu Nobre - Dois no Samba - 01 - Chegue Mais.mp3	pagode
./pagode/Dudu Nobre - Dois no Samba - 03 - Estava Perdido Num Mar.mp3	pagode
./pagode/Dudu Nobre - Dois no Samba - 07 - O Samba Vai Te Pegar.mp3	pagode
./pagode/Dudu Nobre - Dois no Samba - 09 - A Grande Família.mp3	pagode
./pagode/Dudu Nobre - Dois no Samba - 11 - No Mexe-Mexe, No Bole-Bole.mp3	pagode
./pagode/Jeito Moleque - Jeito Moleque - 11 - Rosinha.mp3	pagode
./pagode/Jeito Moleque - Jeito Moleque - 2 - Sobrenatural.mp3	pagode
./pagode/Jeito Moleque - Jeito Moleque - 4 - Eu Nunca Amei Assim.mp3	pagode
./pagode/Jeito Moleque - Jeito Moleque - 5 - Amor Eterno.mp3	pagode
./pagode/Jeito Moleque - Jeito Moleque - 6 - Sua Casa Vai Cair.mp3	pagode
./pagode/Jeito Moleque - Me Faz Feliz Ao vivo - 17 - Marvin.mp3	pagode
./pagode/Jeito Moleque - Me Faz Feliz Ao vivo - 7 - Além do Céu.mp3	pagode
./pagode/Jeito Moleque - Me Faz Feliz Ao vivo - 9 - Pensa.mp3	pagode
./pagode/Katinguelê - Engraçadinha.mp3	pagode
./pagode/Katinguelê - Lua Vai.mp3	pagode
./pagode/Katinguelê - O show vai começar (ao vivo) - 10 - Saudades da Rauinha Viola & O Amor da Gente.mp3	pagode
./pagode/Katinguelê - O show vai começar (ao vivo) - 11 - Anuviou & Canto aos Imortais.mp3	pagode
./pagode/Katinguelê - O show vai começar (ao vivo) - 13 - Pra gente matar a saudade & Recado a minha amada.mp3	pagode
./pagode/Katinguelê - O show vai começar (ao vivo) - 2 - O show vai começar.mp3	pagode
./pagode/Katinguelê - O show vai começar (ao vivo) - 5 - Corpo Lúcido & Ainda Resta uma Bagagem.mp3	pagode
./pagode/Katinguelê - O show vai começar (ao vivo) - 6 - Teu olhar.mp3	pagode
./pagode/Katinguelê - O show vai começar (ao vivo) - 7 - Inaraí & Beijo de mel.mp3	pagode
./pagode/Katinguelê - O show vai começar (ao vivo) - 8 - O grande amor.mp3	pagode
./pagode/Katinguelê - O show vai começar (ao vivo) - 9 - Separação & Cilada.mp3	pagode
./pagode/Swing & Simpatia - Swing & Simpatia - 12 - Festa sem stress.mp3	pagode
./pagode/Swing & Simpatia - Swing & Simpatia - 13 - Estou apaixonado.mp3	pagode
./pagode/Swing & Simpatia - Swing & Simpatia - 4 - Preciso desabafar.mp3	pagode
./pagode/Swing & Simpatia - Swing & Simpatia - 6 - Toda noite.mp3	pagode
./salsa/CELIA CRUZ - CELIA CRUZ & FRIENDS, A NIGHT OF SALSA - 11 - Cucala.mp3	salsa
./salsa/CELIA CRUZ - CELIA CRUZ & FRIENDS, A NIGHT OF SALSA - 3 - La Vida Es Un Carnaval.mp3	salsa
./salsa/CELIA CRUZ - CELIA CRUZ & FRIENDS, A NIGHT OF SALSA - 5 - Medley- Siboney, Babalu, El Cumbanchero.mp3	salsa
./salsa/Eddie Montaivo - Los 100 Mayoreas Exitos De La Salsa CD4 - 18 - Tengo la piel cansada.mp3	salsa
./salsa/Eddie Santiago - De Verdad - 10 - Una Nueva Oportunidad.mp3	salsa
./salsa/Eddie Santiago - De Verdad - 11 - M a.mp3	salsa
./salsa/Eddie Santiago - De Verdad - 12 - Cada Vez.mp3	salsa
./salsa/Eddie Santiago - De Verdad - 13 - Vete.mp3	salsa
./salsa/Eddie Santiago - De Verdad - 14 - Insaciable.mp3	salsa
./salsa/Eddie Santiago - De Verdad - 2 - Me Hiciste Caer.mp3	salsa
./salsa/Eddie Santiago - De Verdad - 3 - Tu Me Quemas.mp3	salsa
./salsa/Eddie Santiago - De Verdad - 7 - Todas.mp3	salsa
./salsa/Eddie Santiago - De Verdad - 8 - Me Fallaste.mp3	salsa
./salsa/Eddie Santiago - Despues DEl Silencio - 2 - Que Duro Me Pego Tu Amor.mp3	salsa
./salsa/Eddie Santiago - Despues DEl Silencio - 6 - Te Deje Escapar.mp3	salsa
./salsa/Eddie Santiago - Despues DEl Silencio - 7 - Lejos De Ti.mp3	salsa
./salsa/Eddie Santiago - Tu me quemas.mp3	salsa
./salsa/Frankie Negron - Amanecer Contigo - 8 - No Renunciare.mp3	salsa
./salsa/Frankie Negron - Con Amor Se Gana - 6 - Fria como el viento.mp3	salsa
./salsa/Frankie Negron - Lo Que Llevo Por Dentro - 1 - Remolino.mp3	salsa
./salsa/Frankie Negron - No Me Compares - 7 - No Quedan Lagrimas.mp3	salsa
./salsa/Frankie Negron - Por Tu Placer - 7 - No Quiero Verte Llorar.mp3	salsa
./salsa/Frankie Negron - Por Tu Placer - 9 - Otro Intento.mp3	salsa
./salsa/Frankie Negron - Siempre Frankie - 10 - Por tu Placer.mp3	salsa
./salsa/Frankie Negron - Siempre Frankie - 11 - No quiero Verte Llorar.mp3	salsa
./salsa/Frankie Negron - Siempre Frankie - 5 - Una Gota de Lluvia.mp3	salsa
./salsa/Frankie Negrón - Lo que llevo por dentro - 8 - Desde Que Te Fuiste.mp3	salsa
./salsa/Giro - Los 100 Mayoreas Exitos De La Salsa CD3 - 19 - Me enamoré.mp3	salsa
./salsa/Jerry Rivera - Lo Nuevo y lo Mejor - 3 - Casi un Hechizo.mp3	salsa
./salsa/Jerry Rivera - Lo Nuevo y lo Mejor - 6 - Amor verdadero.mp3	salsa
./salsa/Jerry Rivera - Lo Nuevo y lo Mejor - 7 - Quiero.mp3	salsa
./salsa/Jerry Rivera - Lo Nuevo y lo Mejor - 8 - Cara de Niño.mp3	salsa
./salsa/Puerto Rican Power - Los 100 Mayoreas Exitos De La Salsa CD2 - 25 - Emergencia de amor.mp3	salsa
./salsa/Puerto Rican Power - Los 100 Mayoreas Exitos De La Salsa CD3 - 20 - Mucho mejor.mp3	salsa
./salsa/Puerto Rican Power - Los 100 Mayoreas Exitos De La Salsa CD4 - 7 - Juguete de nadie.mp3	salsa
./salsa/Quiero hacerte el amor - Los 100 Mayoreas Exitos De La Salsa CD3 - 9 - Tito Rojas.mp3	salsa
./salsa/Roberto Blades - Lagrimas.mp3	salsa
./salsa/Tito Gomez & Tito Rojas - Dejala.mp3	salsa
./salsa/Tito Rojas - Los 100 Mayoreas Exitos De La Salsa CD4 - 5 - Estoy de tu parte.mp3	salsa
./salsa/Trad - Best of salsa - Los latinos - 6 - Marinero.mp3	salsa
./sertaneja/Chitãozinho & Xororó - O melhor de Chitãozinho & Xororó - 10 - O homem quando ama.mp3	sertaneja
./sertaneja/Chitãozinho & Xororó - O melhor de Chitãozinho & Xororó - 3 - Bailão de Peão.mp3	sertaneja
./sertaneja/Chitãozinho & Xororó - O melhor de Chitãozinho & Xororó - 4 - Brincar de ser feliz.mp3	sertaneja
./sertaneja/Chitãozinho & Xororó - Roda de Viola - 10 - Rei do gado.mp3	sertaneja
./sertaneja/Chitãozinho & Xororó - Roda de Viola - 3 - A noite do nosso amor.mp3	sertaneja
./sertaneja/Chitãozinho & Xororó - Roda de Viola - 5 - Berrante de ouro.mp3	sertaneja
./sertaneja/Chitãozinho & Xororó - Roda de Viola - 6 - Estrada.mp3	sertaneja
./sertaneja/Chitãozinho & Xororó - Roda de Viola - 7 - Explode coração.mp3	sertaneja
./sertaneja/Edson & Hudson - Duas Vidas, Dois Amores - 1 - Eu não sei dizer que eu não te amo.mp3	sertaneja
./sertaneja/Edson & Hudson - Duas Vidas, Dois Amores - 14 - Esqueça que eu te amo.mp3	sertaneja
./sertaneja/Edson & Hudson - Duas Vidas, Dois Amores - 4 - Duas vidas, dois amores.mp3	sertaneja
./sertaneja/Edson & Hudson - Duas Vidas, Dois Amores - 7 - Para sempre.mp3	sertaneja
./sertaneja/Edson & Hudson - Duas Vidas, Dois Amores - 8 - Eu nunca amei uma mulher assim.mp3	sertaneja
./sertaneja/Edson & Hudson - Galera Coração - 1 - Galera Coração.mp3	sertaneja
./sertaneja/Edson & Hudson - Galera Coração - 11 - Abre a Janela.mp3	sertaneja
./sertaneja/Edson & Hudson - Galera Coração - 13 - Nossa história.mp3	sertaneja
./sertaneja/Edson & Hudson - Galera Coração - 14 - O caldeirão vai ferver.mp3	sertaneja
./sertaneja/Edson & Hudson - Galera Coração - 3 - Ta no meu coração.mp3	sertaneja
./sertaneja/Edson & Hudson - Galera Coração ao Vivo - 11 - Amor é Ilusão.mp3	sertaneja
./sertaneja/Edson & Hudson - Galera Coração ao Vivo - 7 - Te Quero pra Mim.mp3	sertaneja
./sertaneja/Edson & Hudson - Galera Coração ao Vivo - 8 - Vou Tentar Ser Herói.mp3	sertaneja
./sertaneja/Edson & Hudson - No Limite Da Saudade - 1 - Jura.mp3	sertaneja
./sertaneja/Edson & Hudson - No Limite Da Saudade - 11 - Bye Bye Tristeza.mp3	sertaneja
./sertaneja/Edson & Hudson - No Limite Da Saudade - 3 - No Limite Da Saudade.mp3	sertaneja
./sertaneja/Edson & Hudson - No Limite Da Saudade - 5 - Você É Tudo Que Eu Queria.mp3	sertaneja
./sertaneja/Edson & Hudson - No Limite Da Saudade - 6 - Coração De Mulher.mp3	sertaneja
./sertaneja/Edson & Hudson - No Limite Da Saudade - 7 - Deixa Eu Te Amar.mp3	sertaneja
./sertaneja/Edson & Hudson - No Limite Da Saudade - 8 - Fogo Do Desejo.mp3	sertaneja
./sertaneja/Edson & Hudson - No Limite Da Saudade - 9 - Pra Enganar O Meu Coração.mp3	sertaneja
./sertaneja/Leandro & Leonardo - Dose Dupla - Leandro & Leonardo - 10 - Cai Na Real.mp3	sertaneja
./sertaneja/Leandro & Leonardo - Dose Dupla - Leandro & Leonardo - 11 - Cadê Você.mp3	sertaneja
./sertaneja/Leandro & Leonardo - Dose Dupla - Leandro & Leonardo - 12 - Talvez Você Se Lembre.mp3	sertaneja
./sertaneja/Leandro & Leonardo - Dose Dupla - Leandro & Leonardo - 17 - Pense Em Mim.mp3	sertaneja
./sertaneja/Leandro & Leonardo - Dose Dupla - Leandro & Leonardo - 4 - Quarto Negro.mp3	sertaneja
./sertaneja/Leandro & Leonardo - Dose Dupla - Leandro & Leonardo - 8 - Entre Tapas E Beijos.mp3	sertaneja
./sertaneja/Leandro & Leonardo - Sonho por Sonho - 13 - Vem fazer amor comigo.mp3	sertaneja
./sertaneja/Leandro & Leonardo - Sonho por Sonho - 14 - Índia.mp3	sertaneja
./sertaneja/Leandro & Leonardo - Sonho por Sonho - 4 - Horizonte Azul.mp3	sertaneja
./sertaneja/Leandro & Leonardo - Sonho por Sonho - 7 - Não olhe assim.mp3	sertaneja
./sertaneja/Teodoro e Sampaio - Mulher Chorona - CD2 - 10 - Peão Azarado.mp3	sertaneja
./tango/A Passion For Tango - Authentic Tangos From Argentina - 13 - Asi Se Baila el Tango.mp3	tango
./tango/A Passion For Tango - Authentic Tangos From Argentina - 15 - Balada Para Mi Vida.mp3	tango
./tango/A Passion For Tango - Authentic Tangos From Argentina - 16 - Libertango.mp3	tango
./tango/Astor Piazzolla & Gary Burton - The New Tango - 1 - Milonga is coming.mp3	tango
./tango/Astor Piazzolla & Gary Burton - The New Tango - 6 - Operation tango.mp3	tango
./tango/Astor Piazzolla & Kronos Quartet - Five Tango Sensations - 1 - Asleep.mp3	tango
./tango/Astor Piazzolla & Kronos Quartet - Five Tango Sensations - 2 - Loving.mp3	tango
./tango/Astor Piazzolla & Kronos Quartet - Five Tango Sensations - 3 - Anxiety.mp3	tango
./tango/Carlos Gardel - 1921-00-00 - La copa del olvido.mp3	tango
./tango/Carlos Gardel - 1922-00-00 - Córdoba.mp3	tango
./tango/Carlos Gardel - 1923-00-00 - Alma porteña.mp3	tango
./tango/Carlos Gardel - 1923-00-00 - Padre nuestro.mp3	tango
./tango/Carlos Gardel - 1924-00-00 - La cumparsita [v1].mp3	tango
./tango/Carlos Gardel - 1924-00-00 - Misterio [v1].mp3	tango
./tango/Carlos Gardel - 1925-00-00 - Sentimiento gaucho.mp3	tango
./tango/Carlos Gardel - 1927-02-18 - Barrio reo.mp3	tango
./tango/Carlos Gardel - 1927-03-12 - La violetera.mp3	tango
./tango/Carlos Gardel - 1927-07-22 - Amurado.mp3	tango
./tango/Carlos Gardel - 1927-09-23 - Pobre colombina.mp3	tango
./tango/Carlos Gardel - 1927-10-22 - Perfume de mujer.mp3	tango
./tango/Carlos Gardel - 1927-12-14 - La gloria del águila.mp3	tango
./tango/Carlos Gardel - 1928-06-20 - Reproche.mp3	tango
./tango/Carlos Gardel - 1928-06-26 - Adiós muchachos.mp3	tango
./tango/Carlos Gardel - 1928-10-27 - Barra querida.mp3	tango
./tango/Carlos Gardel - 1928-11-27 - Lo han visto con otra [v1].mp3	tango
./tango/Carlos Gardel - 1929-06-20 - Primero yo.mp3	tango
./tango/Carlos Gardel - 1929-06-21 - Cariñito.mp3	tango
./tango/Carlos Gardel - 1929-06-21 - Seguí mi consejo.mp3	tango
./tango/Carlos Gardel - 1929-07-22 - Milonguera.mp3	tango
./tango/Carlos Gardel - 1929-09-12 - Victoria.mp3	tango
./tango/Carlos Gardel - 1930-04-15 - Lo han visto con otra [v2].mp3	tango
./tango/Carlos Gardel - 1930-04-24 - Viejo smoking [v2].mp3	tango
./tango/Carlos Gardel - 1930-05-20 - Amigazo.mp3	tango
./tango/Carlos Gardel - 1930-05-22 - Por seguidora y por fiel.mp3	tango
./tango/Carlos Gardel - 1930-06-28 - As de cartón.mp3	tango
./tango/Carlos Gardel - 1930-09-30 - La mariposa [v2].mp3	tango
./tango/Carlos Gardel - 1933-08-25 - Cobardía.mp3	tango
./tango/Carlos Gardel - 1934-00-00 - Golondrinas [PELÍCULA].mp3	tango
./tango/Carlos Gardel - 1935-03-20 - Volvió una noche.mp3	tango
./tango/José Ricardo, Guillermo Barbieri, José María Aguilar - 1928-00-00 - La cumparsita [v3] (Instrumental).mp3	tango
./axe/Banda Beijo - Ao vivo - 11 - Qualquer estação.mp3	axe
./axe/Banda Beijo - Ao vivo - 12 - A vida e festa.mp3	axe
./axe/Banda Beijo - Ao vivo - 13 - O arrastão.mp3	axe
./axe/Banda Beijo - Ao vivo - 4 - Barracos.mp3	axe
./axe/Banda Beijo - Ao vivo - 5 - A força do Ilê.mp3	axe
./axe/Banda Beijo - Ao vivo - 6 - Aconteceu.mp3	axe
./axe/Banda Beijo - Ao vivo - 7 - Teu barco no meu mar.mp3	axe
./axe/Cheiro de Amor - Cheiro de Amor (Ao Vivo) 93 - 10 - Me Sinto Só.mp3	axe
./axe/Cheiro de Amor - Cheiro de Amor (Ao Vivo) 93 - 14 - Fazer o Bem.mp3	axe
./axe/Cheiro de Amor - Cheiro de Amor (Ao Vivo) 93 - 16 - Gostava Tanto de Você.mp3	axe
./axe/Cheiro de Amor - Cheiro de Amor (Ao Vivo) 93 - 2 - É o Ouro.mp3	axe
./axe/Cheiro de Amor - Cheiro de Amor (Ao Vivo) 93 - 3 - Auê.mp3	axe
./axe/Cheiro de Amor - Cheiro de Amor (Ao Vivo) 93 - 4 - Canto ao Pescador.mp3	axe
./axe/Cheiro de Amor - Cheiro de Amor (Ao Vivo) 93 - 9 - Nossa Gente (Avisa Lá).mp3	axe
./axe/Daniela Mercury - 20 Grandes Êxitos - 1 - Nobre Vagabundo.mp3	axe
./axe/Daniela Mercury - 20 Grandes Êxitos - 12 - Dona Canô.mp3	axe
./axe/Daniela Mercury - 20 Grandes Êxitos - 16 - Vai Chover.mp3	axe
./axe/Daniela Mercury - 20 Grandes Êxitos - 6 - Rapunzel.mp3	axe
./axe/Daniela Mercury - 20 Grandes Êxitos - 7 - Você Não Entende Nada Cotidiano (Música Incidental).mp3	axe
./axe/Daniela Mercury - 20 Grandes Êxitos - 8 - Minas Com Bahia.mp3	axe
./axe/Daniela Mercury - 20 Grandes Êxitos - 9 - Vulcão Da Liberdade.mp3	axe
./axe/Hamornia do Samba - Vem Nenem.mp3	axe
./axe/Harmonia do Samba - Mandei Meu Cavaco Chorar.mp3	axe
./axe/Harmonia do Samba - Sambe.mp3	axe
./axe/Jammil e Uma Noites - Axé Bahia 2005 - 7 - Lança, Lança.mp3	axe
./axe/Olodum - A Música do Olodum 20 Anos - 10 - Nossa gente Avisa la.mp3	axe
./axe/Olodum - A Música do Olodum 20 Anos - 13 - Berimbau.mp3	axe
./axe/Olodum - Axé Bahia 2005 - 4 - Mania Nacional.mp3	axe
./axe/Tchaka Bum - Axé Bahia 2005 - 16 - Aninha na Praia.mp3	axe
./axe/Timbalada & Caetano Veloso - Axé Bahia 2005 - 9 - Margarida Perfumada (Ao Vivo).mp3	axe
./bachata/Albert Lama - Vete.mp3	bachata
./bachata/Alberto Llanos - En Bandolera.mp3	bachata
./bachata/Alex Bueno & Frank Reyes - Una Espina Saca Otra.mp3	bachata
./bachata/Alex Bueno - Bachata Hits 2004 - 5 - Si Tu Estuvieras.mp3	bachata
./bachata/Alex Bueno - El hijo mio.mp3	bachata
./bachata/Alex Bueno - Ese Hombre Soy Yo.mp3	bachata
./bachata/Alex Bueno - Que Vuelva.mp3	bachata
./bachata/Alex Bueno - Si Alguien Te Hiso Lloral.mp3	bachata
./bachata/Alex Bueno - Te Amo.mp3	bachata
./bachata/Andy Aguilera - Despacio.mp3	bachata
./bachata/Aventura - Ciego de Amor.mp3	bachata
./bachata/Aventura - Dime Si Te Gusto.mp3	bachata
./bachata/Aventura - Ensename a Olvidar.mp3	bachata
./bachata/Aventura - Enseñame A Olvidar.mp3	bachata
./bachata/Aventura - Gone.mp3	bachata
./bachata/Aventura - La Guerra.mp3	bachata
./bachata/Aventura - La Madre.mp3	bachata
./bachata/Aventura - Me Extraña En La Mañana.mp3	bachata
./bachata/Aventura - No me dejes solo.mp3	bachata
./bachata/Aventura - Obsecion.mp3	bachata
./bachata/Aventura - Por Amarte Asi.mp3	bachata
./bachata/Aventura - Todavia Me Amas.mp3	bachata
./bachata/Aventura - Un Poeta Enamorado.mp3	bachata
./bachata/El Gringo De La Bachata - Un poquito de Amor.mp3	bachata
./bachata/El Jeffrey - Cuando Seas Mia.mp3	bachata
./bachata/El Jeffrey - Fue un favol.mp3	bachata
./bachata/Grupo Deseo - Me muero por tu amor.mp3	bachata
./bachata/Luis Miguel del Amargue - Amor de Locos - 3 - Se Fue Mi Amor.mp3	bachata
./bachata/Monchi & Alexandra - No Puedo Vivir Asi.mp3	bachata
./bachata/Varios - Se Fue Mi Amor Bonito-Frank Reyes.mp3	bachata
./bolero/Alejandro Fernandez - Abrázame.mp3	bolero
./bolero/Belchior - De primeira grande.mp3	bolero
./bolero/Boleros Latinos II - 12 - Perhaps, perhaps, perhaps.mp3	bolero
./bolero/Celia Cruz - Boleros Latinos I - 17 - Te busco.mp3	bolero
./bolero/Celia Cruz - Boleros Latinos I - 8 - Bolero, Bolero.mp3	bolero
./bolero/Celia Cruz - La Ceiba - 4 - Y Volvere.mp3	bolero
./bolero/Elis Regina & Cauby - Bolero.mp3	bolero
./bolero/Elymar Santos - Afrodite.mp3	bolero
./bolero/Gilberto Santa Rosa - No Pense Enamorarme Otra Vez.mp3	bolero
./bolero/Gloria Estefan - Boleros Latinos II - 7 - Volverás.mp3	bolero
./bolero/Gloria Estefan - Boleros Latinos III - 18 - Dame otra oportunidad.mp3	bolero
./bolero/Isabel Pantoja - Ese Bolero.mp3	bolero
./bolero/Jose Alberto - Boleros Latinos I - 14 - Mi gran amor le di.mp3	bolero
./bolero/Los Tres Caballeros - El Reloj - 1 - El Reloj.mp3	bolero
./bolero/Los Tres Caballeros - El Reloj - 11 - Mucho Corazon.mp3	bolero
./bolero/Los Tres Caballeros - El Reloj - 3 - Regalame Esta Noche.mp3	bolero
./bolero/Los Tres Caballeros - El Reloj - 4 - Chamaca.mp3	bolero
./bolero/Los Tres Caballeros - El Reloj - 6 - Sabras Que Te Quiero.mp3	bolero
./bolero/Los Tres Caballeros - El Reloj - 7 - Historia De Un Amor.mp3	bolero
./bolero/Los Tres Caballeros - Te Quiero Dijiste.mp3	bolero
./bolero/Los Tres Caballeros - Tres palabras.mp3	bolero
./bolero/Lupita d'Alessio - Boleros Voz Y Sentimiento - CD 01 - 1 - Ya No Me Quieres.mp3	bolero
./bolero/MPB4 - A Lua.mp3	bolero
./bolero/Nico Resende - Contigo aprendi.mp3	bolero
./bolero/Pedro Fernandez - Boleros Voz Y Sentimiento - CD 02 - 9 - Morenita Mia.mp3	bolero
./bolero/Roberto Carlos - Como é grande o meu amor por você.mp3	bolero
./bolero/Roberto Carlos - Música Suave.mp3	bolero
./bolero/Roberto Carlos - No mesmo verão.mp3	bolero
./bolero/Roberto Carlos - O côncavo e o convexo.mp3	bolero
./bolero/Simone & Chico Buarque - Iolanda.mp3	bolero
./forro/Caiana - Menina Bonita.mp3	forro
./forro/Filhos do Nordeste - Te Esperando.mp3	forro
./forro/Luiz Gonzaga - Xote ecológico.mp3	forro
./forro/Rastapé - Aquele Verão.mp3	forro
./forro/Rastapé - Ataiô.mp3	forro
./forro/Rastapé - Bicho do Mato.mp3	forro
./forro/Rastapé - Colo de Menina.mp3	forro
./forro/Rastapé - Embalo do Forró.mp3	forro
./forro/Rastapé - Fale Comigo - 3 - Amor De Rastapé.mp3	forro
./forro/Rastapé - Fale Comigo - 7 - Fale Comigo.mp3	forro
./forro/Rastapé - Forró Drenado.mp3	forro
./forro/Rastapé - Forró no Claro.mp3	forro
./forro/Rastapé - Luau em Dunas.mp3	forro
./forro/Rastapé - Novo Dia.mp3	forro
./forro/Rastapé - Pode relampejar - 10 - Foi deus quem fez voce.mp3	forro
./forro/Rastapé - Pode relampejar - 11 - Preciso do teu sorriso.mp3	forro
./forro/Rastapé - Pode relampejar - 3 - Vai me dizer.mp3	forro
./forro/Rastapé - Pode relampejar - 4 - Disco voador.mp3	forro
./forro/Rastapé - Pode relampejar - 5 - Esse balanço.mp3	forro
./forro/Rastapé - Pode relampejar - 8 - Minha diversão.mp3	forro
./forro/Rastapé - Riso Cristalino & Eu Me Lembro & Pode Morrer Nessa Janela.mp3	forro
./forro/Rastapé - Segredo.mp3	forro
./forro/Rastapé - Um Anjo do Céu.mp3	forro
./forro/Trio Forrozão - Trio Forrozão - 12 - Petrolina Juazeiro.mp3	forro
./forro/Trio Forrozão - Trio Forrozão - 15 - Sou Eu Sim.mp3	forro
./forro/Trio Forrozão - Trio Forrozão - 16 - É Proibido Cochilar.mp3	forro
./forro/Trio Forrozão - Trio Forrozão - 4 - Zé do Rock.mp3	forro
./forro/Trio Forrozão - Trio Forrozão - 5 - Ovo de Codorna.mp3	forro
./forro/Trio Forrozão - Trio Forrozão - 7 - Xote das Meninas.mp3	forro
./forro/Trio Forrozão - Trio Forrozão - 9 - Espuma Aos Vento.mp3	forro
./gaucha/Berenice Azambuj - Baile de Fronteira - 1 - Baile do Sapocay.mp3	gaucha
./gaucha/Chiquito & Bordoneio - Cada Vez Melhor - 3 - Remelexo.mp3	gaucha
./gaucha/Chiquito & Bordoneio - Festchê 1 - 3 - Roda morena.mp3	gaucha
./gaucha/Garotos de Ouro - Dose Dupla - 10 - Tem do.mp3	gaucha
./gaucha/Garotos de Ouro - Dose Dupla - 21 - Desenho animado.mp3	gaucha
./gaucha/Garotos de Ouro - Dose Dupla - 8 - Lembrancas costeiras.mp3	gaucha
./gaucha/Garotos de Ouro - Dose Dupla - 9 - Vanerao do Tio Dudu.mp3	gaucha
./gaucha/Gerson Fogaça - Melhor do que esse - só dois desse - 5 - Vaneira Grossa.mp3	gaucha
./gaucha/Gerson Fogaça - Melhor do que esse - só dois desse - 8 - Tinindo Espora.mp3	gaucha
./gaucha/Grupo Querência - Milongas Gaúchas V2 - 12 - Minha Mania.mp3	gaucha
./gaucha/Grupo Querência - Show de Xote e Vaneirão - 4 - Xote Figurado.mp3	gaucha
./gaucha/Grupo Renascença - Chão Batido - 1 - De Chão  Batido.mp3	gaucha
./gaucha/Grupo Rodeio - Carreteadas - 11 - Natureza Onipotente.mp3	gaucha
./gaucha/Grupo liberdade - Canto E Encanto Nativo - Vol 3 - 17 - janaína.mp3	gaucha
./gaucha/Grupo minuano - Canto E Encanto Nativo - Vol 3 - 13 - te amo guri.mp3	gaucha
./gaucha/João chagas leite - Canto E Encanto Nativo - Vol 3 - 9 - alerta de sangue.mp3	gaucha
./gaucha/Luiz Marenco - Chão Batido - 13 - Filosofia de Andejo.mp3	gaucha
./gaucha/Mano Lima - GAUCHÃO 2005 - 13 - VÉIA CUIUDA.mp3	gaucha
./gaucha/Minuano - GAUCHÃO 2005 - 9 - LÁ VEM ELA.mp3	gaucha
./gaucha/Os Nativos - Santo Chão - 8 - Nova Realidade.mp3	gaucha
./gaucha/Os Serranos - 25 Anos de Música para o Brasil - 1 - Tertúlia.mp3	gaucha
./gaucha/Os Serranos - 25 Anos de Música para o Brasil - 10 - Namoro no Sítio.mp3	gaucha
./gaucha/Os Serranos - 25 Anos de Música para o Brasil - 4 - Pêlos.mp3	gaucha
./gaucha/Os Serranos - 25 Anos de Música para o Brasil - 9 - Bugio Novo.mp3	gaucha
./gaucha/Quero Quero - Músicas da Nossa Terra ZH - 2 - Pé no estribo.mp3	gaucha
./gaucha/Tchê Barbaridade - 10 Anos Mais Fandangueiro - 10 - Ausência.mp3	gaucha
./gaucha/Tchê Barbaridade - 10 Anos Mais Fandangueiro -14 -Vanerão do Adeus - To Maluco.mp3	gaucha
./gaucha/Tchê Barbaridade - 20 Grandes Sucessos - 12 - Vai, Vai no Balanço do Tchê.mp3	gaucha
./gaucha/Tchê Barbaridade - Festchê 1 - 15 - Os ginetes do Brasil.mp3	gaucha
./gaucha/Tchê Guri - GAUCHÃO 2005 - 1 - VEM DANÇAR A VANERA.mp3	gaucha
./merengue/Amarfis - Papa Boco.mp3	merengue
./merengue/Amarfis - To La Mujers Rapan.mp3	merengue
./merengue/Banda Chula Y Raymond Pozo - Merengue Mania 2003 - CD3 - 20 - El Paquetazo.mp3	merengue
./merengue/El Bonche - Merengue Mania 2003 - CD1 - 14 - Se Acabo.mp3	merengue
./merengue/Grupo Mania - Celos Me Provoca.mp3	merengue
./merengue/Grupo Mania - El Caracolito.mp3	merengue
./merengue/Grupo Mania - La Hora De La Verdad - 1 - Grupomania Es Grupomania.mp3	merengue
./merengue/Grupo Mania - La Hora De La Verdad - 10 - Ay Papa.mp3	merengue
./merengue/Grupo Mania - La Hora De La Verdad - 2 - Pelona.mp3	merengue
./merengue/Grupo Mania - La Hora De La Verdad - 4 - No Puedo Olvidarla.mp3	merengue
./merengue/Grupo Mania - La Hora De La Verdad - 5 - Luna.mp3	merengue
./merengue/Grupo Mania - La Hora De La Verdad - 7 - Escucha El Mio.mp3	merengue
./merengue/Grupo Mania - La Hora De La Verdad - 9 - Siento.mp3	merengue
./merengue/Grupo Mania - Me Miras Y Te Miro.mp3	merengue
./merengue/Grupo Mania - Mujeres Soltera.mp3	merengue
./merengue/Grupo Mania - Oro Merenguero - CD1 - 10 - Coranzocito.mp3	merengue
./merengue/Grupo Mania - Oro Merenguero - CD1 - 6 - Me Miras Y Te Miro.mp3	merengue
./merengue/Grupo Mania - Oro Merenguero - CD2 - 7 - Es Un Bombon.mp3	merengue
./merengue/Grupo Mania - Te Esperare.mp3	merengue
./merengue/Mala Fe - Con La Pompi Parriba.mp3	merengue
./merengue/Mambo - Merengue Mania 2003 - CD1 - 1 - Que Quieres De Mi Corazón.mp3	merengue
./merengue/Melina León - Baño De Luna - 2 - Serás.mp3	merengue
./merengue/Melina León - Baño De Luna - 6 - Demasiado Mujer.mp3	merengue
./merengue/Oro Duro - Lo Nuevo 2005 - 1 - La cita.mp3	merengue
./merengue/Oro Duro - Lo Nuevo 2005 - 6 - Nueva York Ta Duro.mp3	merengue
./merengue/Oro Duro - Lo Nuevo 2005 - 7 - La Cabaña.mp3	merengue
./merengue/Papi Sanchez - Suave Mami.mp3	merengue
./merengue/Ricky Castro - Merengue Mania 2003 - CD4 - 12 - Yo Quiero Que Me Quiera.mp3	merengue
./merengue/Tony Swing - Merengue Mania 2003 - CD3 - 10 - Divino Amor.mp3	merengue
./merengue/Zona Roja - Merengue Mania 2003 - CD2 - 10 - Que Dia Es Hoy.mp3	merengue
./pagode/Arlindo Cruz - Pagode do Arlindo - 1 - Bom Ambiente.mp3	pagode
./pagode/Arlindo Cruz - Pagode do Arlindo - 11 - Sorriso de crianca.mp3	pagode
./pagode/Arlindo Cruz - Pagode do Arlindo - 12 - Um sim para quem te gosta.mp3	pagode
./pagode/Arlindo Cruz - Pagode do Arlindo - 13 - O banjo.mp3	pagode
./pagode/Arlindo Cruz - Pagode do Arlindo - 2 - Mulata beleza.mp3	pagode
./pagode/Arlindo Cruz - Pagode do Arlindo - 3 - Sera que e amor.mp3	pagode
./pagode/Arlindo Cruz - Pagode do Arlindo - 4 - malandro sou eu.mp3	pagode
./pagode/Arlindo Cruz - Pagode do Arlindo - 8 - Alem do meu querer.mp3	pagode
./pagode/Art Popular - ao vivo sem abuso - 1 - sem abuso.mp3	pagode
./pagode/Art Popular - ao vivo sem abuso - 10 - você em mim.mp3	pagode
./pagode/Art Popular - ao vivo sem abuso - 13 - dona do meu amor.mp3	pagode
./pagode/Art Popular - ao vivo sem abuso - 2 - carícias.mp3	pagode
./pagode/Art Popular - ao vivo sem abuso - 4 - falando segredo.mp3	pagode
./pagode/Art Popular - ao vivo sem abuso - 9 - megastar.mp3	pagode
./pagode/Kiloucura - Eu Te Amo.mp3	pagode
./pagode/Kiloucura - Pela Vida Inteira.mp3	pagode
./pagode/Zeca Pagodinho & Ivan Milanez - Dois no Samba - 10 - Cada Um No Seu Cada Um.mp3	pagode
./pagode/Zeca Pagodinho - Deixa A Vida Me Levar - 12 - Debaixo Do Meu Chapéu.mp3	pagode
./pagode/Zeca Pagodinho - Deixa A Vida Me Levar - 13 - Nega Judite.mp3	pagode
./pagode/Zeca Pagodinho - Deixa A Vida Me Levar - 5 - Tá Ruim, Mas Tá Bom.mp3	pagode
./pagode/Zeca Pagodinho - Deixa A Vida Me Levar - 7 - Caviar.mp3	pagode
./pagode/Zeca Pagodinho - Deixa A Vida Me Levar - 8 - Calangueei.mp3	pagode
./pagode/Zeca Pagodinho - Deixa Clarear - 11 - Olhos.mp3	pagode
./pagode/Zeca Pagodinho - Deixa Clarear - 12 - Boi.mp3	pagode
./pagode/Zeca Pagodinho - Deixa Clarear - 2 - Deixa Clarear.mp3	pagode
./pagode/Zeca Pagodinho - Deixa Clarear - 3 - Colete Curto & Nega do Patrão.mp3	pagode
./pagode/Zeca Pagodinho - Deixa Clarear - 7 - Dona Encrenca.mp3	pagode
./pagode/Zeca Pagodinho - Dois no Samba - 08 - O Feijão Da Dona Neném.mp3	pagode
./pagode/Zeca Pagodinho - Dois no Samba - 14 - Cabelo No Pão Careca.mp3	pagode
./pagode/Zeca Pagodinho - Dois no Samba - 16 - Lua De Ogum.mp3	pagode
./salsa/Celia Cruz & India - Exitos Eternos - 8 - La Voz de la Experiencia.mp3	salsa
./salsa/Celia Cruz & India - Salsa Divas - 1 - Rie Y Llora.mp3	salsa
./salsa/Celia Cruz & India - Salsa Divas - 2 - Seduceme.mp3	salsa
./salsa/Celia Cruz & India - Salsa Divas - 9 - Hay Que Empezar Otra Vez.mp3	salsa
./salsa/Celia Cruz - Exitos Eternos - 10 - Cúcala [Live].mp3	salsa
./salsa/Celia Cruz - Exitos Eternos - 3 - Que le Den Candela.mp3	salsa
./salsa/Celia Cruz - Exitos Eternos - 7 - Oye Como Va.mp3	salsa
./salsa/Celia Cruz - Exitos Eternos - 9 - Mi Vida Es Cantar.mp3	salsa
./salsa/Celia Cruz - La Ceiba - 3 - Abreme la Puerta.mp3	salsa
./salsa/Celia Cruz - La Ceiba - 8 - La Ceiba y la Siguaraya.mp3	salsa
./salsa/El Gran Combo - Aguacero.mp3	salsa
./salsa/El Gran Combo - Se Me Fue.mp3	salsa
./salsa/Lefty Perez - Los 100 Mayores Exitos De La Musica Salsa CD1 - 23 - Tres.mp3	salsa
./salsa/Marc Anthony - Libre - 1 - Celos.mp3	salsa
./salsa/Marc Anthony - Libre - 3 - Viviendo.mp3	salsa
./salsa/Marc Anthony - Libre - 7 - Yo te quiero.mp3	salsa
./salsa/Marc Anthony - Libre - 8 - Amor aventurero.mp3	salsa
./salsa/Marc Anthony - Otra Nota - 6 - Necesito Amarte.mp3	salsa
./salsa/Marc Anthony - Todo a su tiempo - 1 - Se Me Sigue Olvidando.mp3	salsa
./salsa/Marc Anthony - Todo a su tiempo - 2 - Te conozco bien.mp3	salsa
./salsa/Marc Anthony - Todo a su tiempo - 4 - Nadie Como Ella.mp3	salsa
./salsa/Marc Anthony - Todo a su tiempo - 6 - Llegaste A Mi.mp3	salsa
./salsa/Marc Anthony - Todo a su tiempo - 9 - Vieja Mesa.mp3	salsa
./salsa/Marc Anthony - Valio La Pena - 06 - Amigo.mp3	salsa
./salsa/Marc Anthony - Valio La Pena - 07 - Se Esfuma Tu Amor.mp3	salsa
./salsa/Pedro Conga - Los 100 Mayoreas Exitos De La Salsa CD3 - 14 - Si supieras.mp3	salsa
./salsa/Ruben Dario - Los 100 Mayoreas Exitos De La Salsa CD4 - 16 - Medley del principe.mp3	salsa
./salsa/Scala 40 - Los 100 Mayoreas Exitos De La Salsa CD2 - 14 - Yo que no vivo sin ti.mp3	salsa
./salsa/Willie Colon & Ismael Miranda - No Me Digas Que Es Muy Tarde Ya.mp3	salsa
./salsa/Willy gonzalez - Los 100 Mayoreas Exitos De La Salsa CD4 - 25 - PEqueñas cosas.mp3	salsa
./sertaneja/Rick & Renner - Acústico - 10 Anos De Sucesso - 1 - Só Pensando Em Você.mp3	sertaneja
./sertaneja/Rick & Renner - Acústico - 10 Anos De Sucesso - 11 - Muleca.mp3	sertaneja
./sertaneja/Rick & Renner - Acústico - 10 Anos De Sucesso - 12 - Filha.mp3	sertaneja
./sertaneja/Rick & Renner - Acústico - 10 Anos De Sucesso - 13 - Cara De Pau.mp3	sertaneja
./sertaneja/Rick & Renner - Acústico - 10 Anos De Sucesso - 18 - Eu Sem Você.mp3	sertaneja
./sertaneja/Teodoro & Sampaio - Anna Júlia - 11 - Namorada do carinha.mp3	sertaneja
./sertaneja/Teodoro & Sampaio - Anna Júlia - 13 - Na mira do chifrudo.mp3	sertaneja
./sertaneja/Teodoro & Sampaio - Anna Júlia - 15 - Apaixonado.com.mp3	sertaneja
./sertaneja/Teodoro & Sampaio - Anna Júlia - 17 - Garanhão da madrugada.mp3	sertaneja
./sertaneja/Teodoro & Sampaio - Anna Júlia - 5 - Mulher boa.mp3	sertaneja
./sertaneja/Teodoro & Sampaio - Anna Júlia - 8 - Cunhado - Fale com seu irmão.mp3	sertaneja
./sertaneja/Teodoro & Sampaio - Feito Pra Dançar - 10 - Pé de Pano.mp3	sertaneja
./sertaneja/Teodoro & Sampaio - Feito Pra Dançar - 12 - Sonambulismo.mp3	sertaneja
./sertaneja/Teodoro & Sampaio - Feito Pra Dançar - 13 - O Amor é Cego.mp3	sertaneja
./sertaneja/Teodoro & Sampaio - Feito Pra Dançar - 14 - Vivendo longe do meu bem.mp3	sertaneja
./sertaneja/Teodoro & Sampaio - Feito Pra Dançar - 2 - Põe e Tria.mp3	sertaneja
./sertaneja/Teodoro & Sampaio - Feito Pra Dançar - 4 - Meu Amor Brincou Comigo.mp3	sertaneja
./sertaneja/Teodoro & Sampaio - Feito Pra Dançar - 5 - Desafio do Grenal.mp3	sertaneja
./sertaneja/Teodoro & Sampaio - Feito Pra Dançar - 7 - Terra dos Pampas.mp3	sertaneja
./sertaneja/Teodoro & Sampaio - Mulher Chorona - CD1 - 02 - Alô Mulherada.mp3	sertaneja
./sertaneja/Teodoro & Sampaio - Mulher Chorona - CD1 - 4 - É Mentira Dela.mp3	sertaneja
./sertaneja/Teodoro & Sampaio - Mulher Chorona - CD1 - 6 - Nem Aí.mp3	sertaneja
./sertaneja/Teodoro & Sampaio - Mulher Chorona - CD1 - 7 - Você Quer Largar de Mim.mp3	sertaneja
./sertaneja/Teodoro & Sampaio - Mulher Chorona - CD1 - 9 - Filho da Tuta.mp3	sertaneja
./sertaneja/Teodoro & Sampaio - Mulher Chorona - CD2 - 11 - Psiu.mp3	sertaneja
./sertaneja/Teodoro & Sampaio - Mulher Chorona - CD2 - 12 - Coração Blindado.mp3	sertaneja
./sertaneja/Teodoro & Sampaio - Mulher Chorona - CD2 - 2 - A Gostosona.mp3	sertaneja
./sertaneja/Teodoro & Sampaio - Mulher Chorona - CD2 - 3 - Quando a Saudade Aperta.mp3	sertaneja
./sertaneja/Teodoro & Sampaio - Mulher Chorona - CD2 - 8 - Vou Beber de Novo.mp3	sertaneja
./sertaneja/Teodoro & Sampaio - Mulher Chorona - CD2 - 9 - Cerca de Espinho.mp3	sertaneja
./tango/Astor Piazzolla - Adios Nonino - 2 - La Cachila.mp3	tango
./tango/Astor Piazzolla - Adios Nonino - 4 - Lo Que Vendr.mp3	tango
./tango/Astor Piazzolla - Tango - zero hour - 3 - Concierto para Quinteto.mp3	tango
./tango/Astor Piazzolla - Tango - zero hour - 5 - Michelangelo 70.mp3	tango
./tango/Astor Piazzolla - Tango - zero hour - 7 - Mumuki.mp3	tango
./tango/Carlos Gardel - 1917-00-00 - Mi noche triste [v1].mp3	tango
./tango/Carlos Gardel - 1924-00-00 - Francesita [v2].mp3	tango
./tango/Carlos Gardel - 1926-11-26 - No me tires con la tapa de la olla.mp3	tango
./tango/Carlos Gardel - 1926-12-31 - Gorriones.mp3	tango
./tango/Carlos Gardel - 1927-03-30 - Carnaval.mp3	tango
./tango/Carlos Gardel - 1927-08-20 - Gloria.mp3	tango
./tango/Carlos Gardel - 1928-06-20 - La borrachera del tango.mp3	tango
./tango/Carlos Gardel - 1928-08-17 - Cuando llora la milonga.mp3	tango
./tango/Carlos Gardel - 1928-10-11 - Alma en pena.mp3	tango
./tango/Carlos Gardel - 1928-12-15 - Medianoche.mp3	tango
./tango/Carlos Gardel - 1929-06-28 - La casita está triste.mp3	tango
./tango/Carlos Gardel - 1929-12-11 - Barajando.mp3	tango
./tango/Carlos Gardel - 1929-12-11 - Que se vayan.mp3	tango
./tango/Carlos Gardel - 1930-00-00 - Mano a mano [v3] [Cortometraje].mp3	tango
./tango/Carlos Gardel - 1930-09-17 - Fayuto.mp3	tango
./tango/Carlos Gardel - 1930-09-19 - La violeta.mp3	tango
./tango/Carlos Gardel - 1930-12-01 - Pituca.mp3	tango
./tango/Carlos Gardel - 1931-09-28 - Trovas.mp3	tango
./tango/Carlos Gardel - 1932-00-00 - Silencio [PELÍCULA].mp3	tango
./tango/Carlos Gardel - 1933-02-15 - Ventarrón.mp3	tango
./tango/Carlos Gardel - 1933-02-22 - Recuerdo malevo.mp3	tango
./tango/Carlos Gardel - 1933-03-27 - Silencio [v1].mp3	tango
./tango/Carlos Gardel - 1933-09-18 - Angustias (Llorá corazón).mp3	tango
./tango/Carlos Gardel - 1934-07-30 - Mi Buenos Aires querido.mp3	tango
./tango/Carlos Gardel - 1935-03-20 - Cheating muchachita.mp3	tango
./axe/Araketo - Ao Vivo - 04 - Fanfarra.mp3	axe
./axe/Araketo - Ao Vivo - 2 - Mal Acostumada.mp3	axe
./axe/Araketo - Ao Vivo - 5 - Araketu Bom Demais.mp3	axe
./axe/Araketo - Ao Vivo - 8 - Pipoca.mp3	axe
./axe/Araketo - Ao Vivo - 9 - Mar de Emoção.mp3	axe
./axe/Asa de Águia - Abalou.mp3	axe
./axe/Asa de Águia - Dança do vampiro.mp3	axe
./axe/Asa de Águia - Ja Vou Pintar.mp3	axe
./axe/Asa de Águia - O Que Tem Que Ser Sera.mp3	axe
./axe/Axé Blond - Pancadão.mp3	axe
./axe/Axé Blond - Pra Quebrar.mp3	axe
./axe/Banda Cheiro de Amor - Ao Vivo - 1 - Vai sacudir vai abalar.mp3	axe
./axe/Banda Cheiro de Amor - Ao Vivo - 10 - Lero Lero.mp3	axe
./axe/Banda Cheiro de Amor - Ao Vivo - 2 - Pot Pourri Frevo.mp3	axe
./axe/Banda Cheiro de Amor - Ao Vivo - 3 - Rebentão.mp3	axe
./axe/Banda Cheiro de Amor - Ao Vivo - 8 - É Demais Meu Rei.mp3	axe
./axe/Banda Cheiro de Amor - Pega no Balanço.mp3	axe
./axe/Banda Cheiro de Amor - Pureza da Paixão.mp3	axe
./axe/Banda Cheiro de Amor - Pureza de Paixão.mp3	axe
./axe/Banda Eva - Beleza Rara.mp3	axe
./axe/Banda Eva - Vem Meu Amor.mp3	axe
./axe/Banda Planeta Axé - Axé Bahia 2005 - 11 - Amor Pra Dar.mp3	axe
./axe/Ivente Sangalo & Gilberto Gil - Céu Da Boca.mp3	axe
./axe/Ivete Sangalo - Aqui Vai Rolar.mp3	axe
./axe/Ivete Sangalo - Axé Bahia 2004 - 3 - Azul da moda.mp3	axe
./axe/Ivete Sangalo - Bug Bug Bye Bye.mp3	axe
./axe/Ivete Sangalo - Carro Velho.mp3	axe
./axe/Ivete Sangalo - Chupa Toda.mp3	axe
./axe/Ivete Sangalo - Penso.mp3	axe
./axe/Oz Bambaz - Bam Bam Bam.mp3	axe
./bachata/Alex El Biscochito - Dos Amantes.mp3	bachata
./bachata/Bachata Duo - Me enganaste con el.mp3	bachata
./bachata/Daniel Moncion - Si Te Vas.mp3	bachata
./bachata/El Chaval - Vuelve.mp3	bachata
./bachata/El Grupo Romance - Dimelo Bajito.mp3	bachata
./bachata/Elvis Martinez - Lloraras.mp3	bachata
./bachata/Elvis Martinez - Mi Historia Entre Tus Dedos.mp3	bachata
./bachata/Elvis Martinez - Que Sera De Mi.mp3	bachata
./bachata/Elvis Martinez - Serpiente Venenosa.mp3	bachata
./bachata/Enrique Feliz - Galleticas De Avena.mp3	bachata
./bachata/Frank Reyes - Cuando te conoci.mp3	bachata
./bachata/Frank Reyes - Dejame Entrar En Ti.mp3	bachata
./bachata/Frank Reyes - Mal Querida.mp3	bachata
./bachata/Frank Reyes - Quiero Saber De Ti.mp3	bachata
./bachata/Frankie Negron - Por Tu Placer - 12 - Comerte A Besos (bachata).mp3	bachata
./bachata/Luis Miguel del Amargue - Amor de Locos - 5 - Que Diera Un Nino.mp3	bachata
./bachata/Luis Miguel del Amargue - Amor de Locos - 7 - Si Yo Me Muero.mp3	bachata
./bachata/Raulin Rodriguez - Piel Sin Alma - 2 - Solo Quiereme.mp3	bachata
./bachata/Raulin Rodriguez - Piel Sin Alma - 3 - Despues De Tanto Amor.mp3	bachata
./bachata/Raulin Rodriguez - Piel Sin Alma - 4 - Te Pierdo y Te Pienso.mp3	bachata
./bachata/Raulin Rodriguez - Piel Sin Alma - 8 - Ya Te Vas Amor.mp3	bachata
./bachata/Raulin Rodriguez - Piel Sin Alma - 9 - Mi Mejor Amiga.mp3	bachata
./bachata/Tabaco & Sus Metales - Las Viejas.mp3	bachata
./bachata/Tego Calderon - Plante Bandera.mp3	bachata
./bachata/Yoskar Sarante - El Amor.mp3	bachata
./bachata/Yoskar Sarante - Eres Un Mal Necesario.mp3	bachata
./bachata/Yoskar Sarante - He Tenido que Llorar.mp3	bachata
./bachata/Yoskar Sarante - No te Detengas.mp3	bachata
./bachata/Yoskar Sarante - Por Que Muero.mp3	bachata
./bachata/Yoskar Sarante - Se Me Ha Cansado.mp3	bachata
./bolero/Angela Rô Rô - Simples Carinho.mp3	bolero
./bolero/Angelica Maria - Boleros Voz Y Sentimiento - CD 01 - 7 - Si Me Comprendieras.mp3	bolero
./bolero/Bachata Magic - Boleros Latinos III - 9 - Me estoy enamorando.mp3	bolero
./bolero/Caetano Veloso - Boleros Latinos I - 19 - Mi cocodrilo verde.mp3	bolero
./bolero/Caetano Veloso - Boleros Latinos II - 11 - Maria de La O.mp3	bolero
./bolero/Caetano Veloso - Você é linda.mp3	bolero
./bolero/Fred Mercury & Monserrat Cabale - How Can I Go On.mp3	bolero
./bolero/Gal Costa & Erasmo Carlos - Detalhes.mp3	bolero
./bolero/João Bosco - Dois pra lá, Dois pra cá.mp3	bolero
./bolero/João Bosco - Latin Lover.mp3	bolero
./bolero/João Bosco - Papel mache.mp3	bolero
./bolero/Juan Luis Guerra - Boleros Latinos I - 2 - Frio Frio.mp3	bolero
./bolero/Juan Luis Guerra - Boleros Latinos II - 13 - Estrellitas y duendes.mp3	bolero
./bolero/Juan Luis Guerra - Boleros Latinos III - 17 - Palomita blanca.mp3	bolero
./bolero/Lucho Gatica - Contigo en la distancia.mp3	bolero
./bolero/Lucho Gatica - La Barca.mp3	bolero
./bolero/Lupita d`Alessio - Boleros Voz Y Sentimiento - CD 02 - 1 - Ya No Me Quieres.mp3	bolero
./bolero/Marc Antony - Grandes Exitos - 9 - Hasta Ayer.mp3	bolero
./bolero/Mariano - Nosso Mundo.mp3	bolero
./bolero/Monna Bell - Boleros Voz Y Sentimiento - CD 02 - 11 - Cuando Vuelvas.mp3	bolero
./bolero/Nana Caymmi - Resposta ao tempo.mp3	bolero
./bolero/Ney Matogrosso - Tanto Amar.mp3	bolero
./bolero/Pedro Vargas - El Reloj.mp3	bolero
./bolero/Pedro Vargas - Flores Negras.mp3	bolero
./bolero/Pedro Vargas - La Noche de Anoche.mp3	bolero
./bolero/Pedro Vargas - La Ultima Noche.mp3	bolero
./bolero/Pedro Vargas - Mujer.mp3	bolero
./bolero/Roupa Nova - Amar É.mp3	bolero
./bolero/Zizi Possi - A Paz.mp3	bolero
./bolero/Zizi Possi - Perigo.mp3	bolero
./forro/Falamansa & Trio Virgulino - A peleja do diabo.mp3	forro
./forro/Forróçacana - Bola De Meia.mp3	forro
./forro/Forróçacana - Essa Menina Mulher da Pele Preta.mp3	forro
./forro/Forróçacana - Esverdear.mp3	forro
./forro/Forróçacana - Matilde.mp3	forro
./forro/Luiz Gonzaga & Trio Virgulino - Xote das meninas.mp3	forro
./forro/Rastapé & Baião de Quatro - O Som do Forró - 1 - Amor de rastapé.mp3	forro
./forro/Rastapé & Baião de Quatro - O Som do Forró - 12 - Coração virado.mp3	forro
./forro/Rastapé & Baião de Quatro - O Som do Forró - 3 - Forró em Limoeiro & Sebastiana & O canto da ema.mp3	forro
./forro/Rastapé & Baião de Quatro - O Som do Forró - 4 - Eu só quero um xodó & É proibido cochilar & Vem morena.mp3	forro
./forro/Rastapé & Baião de Quatro - O Som do Forró - 5 - Horoína.mp3	forro
./forro/Rastapé & Baião de Quatro - O Som do Forró - 8 - Língua de jacaré.mp3	forro
./forro/Rastapé & Baião de Quatro - O Som do Forró - 9 - Pequenininha & Até mais vê.mp3	forro
./forro/Trio Nordestino - Arte Culinária.mp3	forro
./forro/Trio Nordestino - Chap-Chap.mp3	forro
./forro/Trio Nordestino - Chupando gelo.mp3	forro
./forro/Trio Nordestino - Conversa de motorista.mp3	forro
./forro/Trio Nordestino - Ela beslicando ele.mp3	forro
./forro/Trio Nordestino - Fartura de Beijo.mp3	forro
./forro/Trio Nordestino - Forró Desarmado.mp3	forro
./forro/Trio Nordestino - Forró Quentão.mp3	forro
./forro/Trio Nordestino - Meu Pitiguari.mp3	forro
./forro/Trio Nordestino - No balanço.mp3	forro
./forro/Trio Nordestino - O Bicho Bom.mp3	forro
./forro/Trio Nordestino - Pau de Arara é A Vovozinha.mp3	forro
./forro/Trio Nordestino - Seleção de Ouro - 20 Sucessos I - 12 - São João no quintal.mp3	forro
./forro/Trio Nordestino - Seleção de Ouro - 20 Sucessos I - 15 - Amor não faz mal.mp3	forro
./forro/Trio Nordestino - Seleção de Ouro - 20 Sucessos I - 3 - Carta 100 erros.mp3	forro
./forro/Trio Nordestino - Seleção de Ouro - 20 Sucessos I - 5 - Apague o candieiro.mp3	forro
./forro/Trio Zeferino - Galo Velho.mp3	forro
./gaucha/Adair de Freitas - Milongas Gaúchas V2 - 10 - Milnga da Solidão.mp3	gaucha
./gaucha/Alma Serrana - Alma Serrana - Ao vivo - 1 - Dança Serrana & Vem Serranear & Serrana Mania.mp3	gaucha
./gaucha/Alma Serrana - Alma Serrana - Ao vivo - 17 - O Garrafão.mp3	gaucha
./gaucha/Alma Serrana - Alma Serrana - Ao vivo - 21 - Chico Porteiro - Roda Morena.mp3	gaucha
./gaucha/Alma Serrana - Alma Serrana - Ao vivo - 23 - Dormi na Praça.mp3	gaucha
./gaucha/Alma Serrana - Alma Serrana - Ao vivo - 24 - Boneca Cobiçada.mp3	gaucha
./gaucha/Alma Serrana - Alma Serrana - Ao vivo - 5 - O Índio e o Bugio.mp3	gaucha
./gaucha/Alma Serrana - Alma Serrana - Ao vivo - 8 - Baialanta da Neca Maria.mp3	gaucha
./gaucha/Chiquito & Bordoneio - Cada Vez Melhor - 1 - Do Tamanho do Brasil.mp3	gaucha
./gaucha/Garotos de Ouro - Baile de Fronteira - 4 - Gaitita.mp3	gaucha
./gaucha/Garotos de Ouro - Dose Dupla - 11 - Siga em frente.mp3	gaucha
./gaucha/Garotos de Ouro - Dose Dupla - 14 - Vanerao do nego Nereu.mp3	gaucha
./gaucha/Garotos de Ouro - Dose Dupla - 19 - Peao farrapo.mp3	gaucha
./gaucha/Grupo Chamamento - Chão Batido - 4 - Dia de Cambicho.mp3	gaucha
./gaucha/Grupo Rodeio - Carreteadas - 6 - Pensando.mp3	gaucha
./gaucha/Gurizada Medonha - Só Vanerão - Volume 4 - 3 - Bailes de Pegá Cria.mp3	gaucha
./gaucha/Luiz Carlos Borges - Festchê 1 - 9 - Coração de gaiteiro.mp3	gaucha
./gaucha/O Cancioneiro - Os Melhores Xotes Gaúchos Vol. 1 - 10 - Vida de Campeiro.mp3	gaucha
./gaucha/Os Caciques - Só Vanerão - Volume 4 - 15 - Fandango dos Caciques.mp3	gaucha
./gaucha/Os Mateadores - Só Vanerão - Volume 4 - 5 - Polvadeira.mp3	gaucha
./gaucha/Os Milongueiros - Show de Xote e Vaneirão - 10 - Fazendo Proposta.mp3	gaucha
./gaucha/Os Serranos - Os Melhores Xotes Gaúchos Vol. 1 - 2 - Baile de Mariquinha.mp3	gaucha
./gaucha/Os Tiranos - Só Vanerão - Volume 4 - 9 - Fandangueiro de Galpão.mp3	gaucha
./gaucha/Pedro Ortaça - Chão Batido - 6 - De Guerreiro a Payador.mp3	gaucha
./gaucha/Tchê Barbaridade - 20 Grandes Sucessos - 1 - Hino Rio-Grandense.mp3	gaucha
./gaucha/Tchê Barbaridade - 20 Grandes Sucessos - 10 - Bica que Bica.mp3	gaucha
./gaucha/Tchê Barbaridade - 20 Grandes Sucessos - 11 - O Tchê Chegou!.mp3	gaucha
./gaucha/Tchê Barbaridade - 20 Grandes Sucessos - 17 - Festa na Rua.mp3	gaucha
./gaucha/Tchê Barbaridade - 20 Grandes Sucessos - 18 - Bugio KIlha.mp3	gaucha
./gaucha/Todos do Festchê - Festchê 1 - 8 - Eu sou do Sul.mp3	gaucha
./merengue/Alex Bueno - Me Muero Por Ella.mp3	merengue
./merengue/Angelito Villalona - Merengue Mania 2003 - CD3 - 11 - Secreto de Amor.mp3	merengue
./merengue/Arena Fina - Merengue Mania 2003 - CD4 - 17 - Estes Donde Estes.mp3	merengue
./merengue/D. Fernandez & C. Rodriguez - Merengue Mania 2003 - CD4 - 15 - No Me Dejes.mp3	merengue
./merengue/Grupo Mio - Ella Ta Ahi.mp3	merengue
./merengue/Juan Luis Guerra - De Tu Boca.mp3	merengue
./merengue/Juan Luis Guerra - Las Avispas.mp3	merengue
./merengue/Juan Luis Guerra - Me Enamoro De Ella.mp3	merengue
./merengue/La Banda Gorda - Calienta Esto - 7 - Vaya Donde Vayas.mp3	merengue
./merengue/La Banda Gorda - Calienta Esto - 8 - Coge Ahi.mp3	merengue
./merengue/La Banda Gorda - Calienta Esto - 9 - Te Recordare.mp3	merengue
./merengue/La Banda Gorda - Esta Noche - 1 - Gozando.mp3	merengue
./merengue/La Banda Gorda - Esta Noche - 10 - El Mismo Calor.mp3	merengue
./merengue/La Banda Gorda - Esta Noche - 2 - Esta Noche.mp3	merengue
./merengue/La Banda Gorda - Esta Noche - 3 - Subindo En El Palo.mp3	merengue
./merengue/La Banda Gorda - Esta Noche - 7 - Esperando.mp3	merengue
./merengue/La Banda Gorda - Esta Noche - 9 - Preso.mp3	merengue
./merengue/La Banda Gorda - Puro Mambo - 1 - Dejalo Ahi.mp3	merengue
./merengue/La Banda Gorda - Puro Mambo - 4 - No Doy Mi Truco.mp3	merengue
./merengue/La Banda Gorda - Puro Mambo - 5 - Mi Negra.mp3	merengue
./merengue/La Banda Gorda - Puro Mambo - 6 - Dame.mp3	merengue
./merengue/Los Sabrosos Del Merengue - Merengue Mania 2003 - CD2 - 2 - No Llorare.mp3	merengue
./merengue/Reynaldo Rey - Merengue Mania 2003 - CD1 - 8 - Ganas de Llorar.mp3	merengue
./merengue/Rokabanda - Merengue Mania 2003 - CD3 - 14 - Te La Luciste.mp3	merengue
./merengue/Ronny Moreno - Matame.mp3	merengue
./merengue/Toño Rosario - La Alegria Del Merengue - 8 - Donde.mp3	merengue
./merengue/Toño Rosario - La Alegria Del Merengue - 9 - Como Voy a Decir.mp3	merengue
./merengue/Toño Rosario - Resistire.mp3	merengue
./merengue/Tulile - Te Boto La Tipa.mp3	merengue
./merengue/Victor Roque Y La Gran Manzana - Merengue Mania 2003 - CD3 - 12 - Las Minifaldas.mp3	merengue
./pagode/Dudo Nobre - Ao Vivo - 7 - Feliz Da Vida.mp3	pagode
./pagode/Exalta Samba - Luz do Desejo - 10 - Dom de Sonhar.mp3	pagode
./pagode/Exalta Samba - Luz do Desejo - 13 - Um Beijo Seu.mp3	pagode
./pagode/Exalta Samba - Luz do Desejo - 14 - Armadilha.mp3	pagode
./pagode/Exalta Samba - Luz do Desejo - 3 - É você.mp3	pagode
./pagode/Exalta Samba - Luz do Desejo - 5 - Doidinho.mp3	pagode
./pagode/Exalta Samba - Pagode de Mesa ao Vivo - 11 - Onde Mora o Pagode & Essa é a hora & Olho Grande.mp3	pagode
./pagode/Exalta Samba - Pagode de Mesa ao Vivo - 12 - Faça o que eu digo.mp3	pagode
./pagode/Exalta Samba - Pagode de Mesa ao Vivo - 2 - Pago pra ver.mp3	pagode
./pagode/Exalta Samba - Pagode de Mesa ao Vivo - 4 - Gamei & Mais uma vez & Carona do Amor.mp3	pagode
./pagode/Exalta Samba - Pagode de Mesa ao Vivo - 5 - Eu você sempre.mp3	pagode
./pagode/Exalta Samba - Pagode de Mesa ao Vivo - 8 - Fogo Selvagem.mp3	pagode
./pagode/Exalta Samba - Pagode de Mesa ao Vivo - 9 - Armadilha & Amor e Amizade.mp3	pagode
./pagode/Grupo Sensação - Brilho de felicidades - 1 - Sorrriso de marfin.mp3	pagode
./pagode/Grupo Sensação - Brilho de felicidades - 11 - Preciso te encontrar.mp3	pagode
./pagode/Grupo Sensação - Brilho de felicidades - 12 - Amei.mp3	pagode
./pagode/Grupo Sensação - Brilho de felicidades - 6 - Coração dispara.mp3	pagode
./pagode/Grupo Sensação - Brilho de felicidades - 8 - Zumbi (Espírito de luz).mp3	pagode
./pagode/Grupo Sensação - Brilho de felicidades - 9 - Louco de alegria.mp3	pagode
./pagode/Os Morenos - Amor de Verão (Ao Vivo).mp3	pagode
./pagode/Os Travessos - Alo.mp3	pagode
./pagode/Sorriso Maroto - Ao vivo na Providência - 1 - Coração Deserto.mp3	pagode
./pagode/Sorriso Maroto - Ao vivo na Providência - 4 - E agora.mp3	pagode
./pagode/Sorriso Maroto - Ao vivo na Providência - 6 - Preciso viver.mp3	pagode
./pagode/Sorriso Maroto - Ao vivo na Providência - 8 - Eu Vacilei.mp3	pagode
./pagode/Sorriso Maroto - Por Você Ao Vivo - 11 - Por Você.mp3	pagode
./pagode/Sorriso Maroto - Por Você Ao Vivo - 14 - Nada de Pensar Em Despedida & Marque um Lugar & Preciso Viver.mp3	pagode
./pagode/Sorriso Maroto - Por Você Ao Vivo - 4 - Eu Vacilei.mp3	pagode
./pagode/Sorriso Maroto - Por Você Ao Vivo - 6 -  E Agora & Cade Você.mp3	pagode
./pagode/Sorriso Maroto - Por Você Ao Vivo - 9 - Diz Que Quer Ficar.mp3	pagode
./salsa/EDDIE SANTIAGO - DISCO DE ORO (CD 1) - 4 - ANTIDOTO Y VENENO.mp3	salsa
./salsa/EDDIE SANTIAGO - DISCO DE ORO (CD 1) - 7 - TODO EMPEZO.mp3	salsa
./salsa/EDDIE SANTIAGO - ORO SALSERO (CD2) - 10 - CADA VEZ.mp3	salsa
./salsa/EDDIE SANTIAGO - ORO SALSERO (CD2) - 4 - CABALGATA.mp3	salsa
./salsa/EDDIE SANTIAGO - ORO SALSERO (CD2) - 8 - MAÑANA.mp3	salsa
./salsa/Gilberto Santa Rosa - Amor mio no te vayas.mp3	salsa
./salsa/Gilberto Santa Rosa - Aparentemente.mp3	salsa
./salsa/Gilberto Santa Rosa - Como te hago entender.mp3	salsa
./salsa/Gilberto Santa Rosa - Pero no me ama.mp3	salsa
./salsa/Gilberto Santa Rosa - Vivir sin ella.mp3	salsa
./salsa/Grupo Niche - El preso.mp3	salsa
./salsa/Josean - Los 100 Mayoreas Exitos De La Salsa CD2 - 12 - Te extraño, te olvido, te amo.mp3	salsa
./salsa/Luis Enrique - Los 100 Mayoreas Exitos De La Salsa CD3 - 24 - Así es la vida.mp3	salsa
./salsa/Marc Antony & La India - Grandes Exitos - 15 - Vivir lo Nuestro.mp3	salsa
./salsa/Ommar - Los 100 Mayores Exitos De La Musica Salsa CD1 - 20 - La chula.mp3	salsa
./salsa/Primera clase - Los 100 Mayoreas Exitos De La Salsa CD4 - 10 - Vuelveme a querer.mp3	salsa
./salsa/Raulin Rosendo - Los 100 Mayoreas Exitos De La Salsa CD2 - 20 - Lady Laura.mp3	salsa
./salsa/Raulin Rosendo - Los 100 Mayoreas Exitos De La Salsa CD4 - 3 - Procuro olvidarte.mp3	salsa
./salsa/Raulin Rosendo - Los 100 Mayores Exitos De La Musica Salsa CD1 - 16 - Uno se cura.mp3	salsa
./salsa/Rey Ruiz - Creo En El Amor.mp3	salsa
./salsa/Rey Ruiz - Mi Media Mitad.mp3	salsa
./salsa/Rey Ruiz - Mi Tentacion - 2 - Creo En El Amor (Salsa).mp3	salsa
./salsa/Rey Ruiz - Mi Tentacion - 3 - De Ti No Me Canso.mp3	salsa
./salsa/Rey Ruiz - Mi Tentacion - 7 - Te Vas A Arrepentir.mp3	salsa
./salsa/Rey Ruiz - No Me Acostumbro.mp3	salsa
./salsa/Rey Ruiz - Te propongo.mp3	salsa
./salsa/Roberto Torres - Los 100 Mayoreas Exitos De La Salsa CD4 - 21 - Caballo Viejo.mp3	salsa
./salsa/Salsa unica - Los 100 Mayoreas Exitos De La Salsa CD2 - 1 - La fuerza del corrazon.mp3	salsa
./salsa/Victor Manuelle - Dile a ella.mp3	salsa
./salsa/Victor Manuelle - Me Da Lo Mismo.mp3	salsa
./sertaneja/Bruno & Marrone - Ao Vivo - 10 - Será.mp3	sertaneja
./sertaneja/Bruno & Marrone - Ao Vivo - 13 - Ligação Urbana.mp3	sertaneja
./sertaneja/Bruno & Marrone - Ao Vivo - 14 - Então pode ir.mp3	sertaneja
./sertaneja/Bruno & Marrone - Ao Vivo - 15 - Sonhos Perdidos.mp3	sertaneja
./sertaneja/Bruno & Marrone - Ao Vivo - 19 - Vai dar namoro.mp3	sertaneja
./sertaneja/Bruno & Marrone - Ao Vivo - 7 - Credo em Cruz & Ave Maria & Pra lá que eu vou.mp3	sertaneja
./sertaneja/Bruno & Marrone - Meu presente é você - 12 - Raridade.mp3	sertaneja
./sertaneja/Bruno & Marrone - Meu presente é você - 15 - Se não for por amor.mp3	sertaneja
./sertaneja/Bruno & Marrone - Meu presente é você - 3 - Quer casar comigo.mp3	sertaneja
./sertaneja/Bruno & Marrone - Meu presente é você - 4 - Por um gole a mais.mp3	sertaneja
./sertaneja/Bruno & Marrone - Meu presente é você - 5 - Faz mais, Faz.mp3	sertaneja
./sertaneja/Edson & Hudson - Galera Coração - 12 - Por amar essa ilusão.mp3	sertaneja
./sertaneja/Edson & Hudson - Galera Coração - 5 - Solte a Garganta.mp3	sertaneja
./sertaneja/Edson & Hudson - Galera Coração - 7 - Chocolate com pimenta.mp3	sertaneja
./sertaneja/Edson & Hudson - Galera Coração - 8 - Chega Junto.mp3	sertaneja
./sertaneja/Edson & Hudson - Galera Coração - 9 - Amor e Ilusão.mp3	sertaneja
./sertaneja/Guilherme & Santiago - Vol. 08 - 1 - Alô Meu Povo.mp3	sertaneja
./sertaneja/Guilherme & Santiago - Vol. 08 - 10 - Cada Vez Mais.mp3	sertaneja
./sertaneja/Guilherme & Santiago - Vol. 08 - 11 - Preciso Desse Amor.mp3	sertaneja
./sertaneja/Guilherme & Santiago - Vol. 08 - 12 - Blusa Vermelha & Último Adeus.mp3	sertaneja
./sertaneja/Guilherme & Santiago - Vol. 08 - 13 - Do Outro Lado Da Cidade.mp3	sertaneja
./sertaneja/Guilherme & Santiago - Vol. 08 - 14 - E Pra Sempre Te Amar.mp3	sertaneja
./sertaneja/Guilherme & Santiago - Vol. 08 - 7 - Eu Gosto De Mulher.mp3	sertaneja
./sertaneja/Guilherme & Santiago - Vol. 08 - 8 - Vem Brincar De Amar.mp3	sertaneja
./sertaneja/Zezé Di Camargo & Luciano - Zezé Di Camargo & Luciano - 1 - A Minha História.mp3	sertaneja
./sertaneja/Zezé Di Camargo & Luciano - Zezé Di Camargo & Luciano - 10 - Mil Anos de Amor.mp3	sertaneja
./sertaneja/Zezé Di Camargo & Luciano - Zezé Di Camargo & Luciano - 12 - Sou Parada Dura.mp3	sertaneja
./sertaneja/Zezé Di Camargo & Luciano - Zezé Di Camargo & Luciano - 14 - Paguei Pra Ver.mp3	sertaneja
./sertaneja/Zezé Di Camargo & Luciano - Zezé Di Camargo & Luciano - 15 - Agora Aguenta Nóis.mp3	sertaneja
./sertaneja/Zezé Di Camargo & Luciano - Zezé Di Camargo & Luciano - 9 - Fica de Uma Vez.mp3	sertaneja
./tango/A Passion For Tango - Authentic Tangos From Argentina - 1 - Mi Buenos Aires Querido - Payadora.mp3	tango
./tango/A Passion For Tango - Authentic Tangos From Argentina - 17 - Fuga y Misterio.mp3	tango
./tango/A Passion For Tango - Authentic Tangos From Argentina - 4 - Nostalgias.mp3	tango
./tango/A Passion For Tango - Authentic Tangos From Argentina - 7 - Milonga de Mis Amores.mp3	tango
./tango/Carlos Gardel - 1923-00-00 - El huérfano.mp3	tango
./tango/Carlos Gardel - 1924-00-00 - Cascabelito.mp3	tango
./tango/Carlos Gardel - 1925-00-00 - Fea.mp3	tango
./tango/Carlos Gardel - 1926-00-00 - Mocosita.mp3	tango
./tango/Carlos Gardel - 1927-05-05 - Arrabalero.mp3	tango
./tango/Carlos Gardel - 1927-06-21 - Mala entraña.mp3	tango
./tango/Carlos Gardel - 1927-07-08 - Un tropezón.mp3	tango
./tango/Carlos Gardel - 1927-07-20 - A la luz del candil [v1].mp3	tango
./tango/Carlos Gardel - 1927-12-16 - Cuando volverás.mp3	tango
./tango/Carlos Gardel - 1928-10-20 - Bandoneón arrabalero.mp3	tango
./tango/Carlos Gardel - 1928-11-27 - La reina del tango.mp3	tango
./tango/Carlos Gardel - 1930-04-01 - Buenos Aires.mp3	tango
./tango/Carlos Gardel - 1930-05-31 - Contramarca.mp3	tango
./tango/Carlos Gardel - 1930-10-17 - Anoche a las dos [v1].mp3	tango
./tango/Carlos Gardel - 1931-09-04 - Ofrenda maleva.mp3	tango
./tango/Carlos Gardel - 1931-09-16 - Esclavas blancas.mp3	tango
./tango/Carlos Gardel - 1931-09-28 - Tomo y obligo [v1].mp3	tango
./tango/Carlos Gardel - 1932-07-22 - Otario que andás penando.mp3	tango
./tango/Carlos Gardel - 1933-02-22 - Acquaforte.mp3	tango
./tango/Carlos Gardel - 1933-06-17 - Desdén.mp3	tango
./tango/Carlos Gardel - 1934-07-30 - Golondrinas.mp3	tango
./tango/Carlos Gardel - 1934-08-24 - Amargura [v1].mp3	tango
./tango/Horacio Salgán - Trayectoria - 14 - Gallo Ciego.mp3	tango
./tango/Horacio Salgán - Trayectoria - 5 - La Luz De Un Fosforo.mp3	tango
./tango/Horacio Salgán - Trayectoria - 7 - Hotel Victoria.mp3	tango
./tango/Horacio Salgán - Trayectoria - 9 - Orgullo Criollo.mp3	tango
